"ID";"NumeroFactura";"FechaFactura";"NumeroRadicado";"FechaRadicado";"NumeroContrato";"ValorDocumento";"ValorMenosImpuestos";"Impuestos";"OtrosDescuentos";"TotalPagos";"TotalAnticipos";"TotalGlosaInicial";"TotalGlosaFavor";"TotalGlosaContra";"GlosaXConciliar";"ValorSegunEPS";"ValorSegunIPS";"Diferencia"
"1810";"1394551";"2017-04-07";"72462";"2017-04-07";"H-593-15 OTRO SI NRO 003";"830165";"813562";"16603";"0";"571000";"300000";"270320";"209920";"60400";"0";"-267358";"60400";"-327758"
"1811";"1397991";"2017-04-07";"72462";"2017-04-07";"H-593-15 OTRO SI NRO 003";"888790";"871014";"17776";"0";"0";"0";"270320";"209920";"60400";"0";"661094";"60400";"600694"
"1812";"1390085";"2017-04-07";"72845";"2017-04-07";"H-593-15 OTRO SI NRO 003";"149410";"146422";"2988";"0";"0";"0";"88000";"13300";"74700";"0";"133122";"74700";"58422"
"1813";"1393088";"2017-04-07";"72914";"2017-04-07";"H-593-15 OTRO SI NRO 003";"708414";"770686";"-62272";"0";"0";"0";"311315";"18414";"292901";"0";"752272";"292901";"459371"
"1814";"1393184";"2017-04-07";"72914";"2017-04-07";"H-593-15 OTRO SI NRO 003";"242694";"237840";"4854";"0";"0";"0";"157500";"0";"157500";"0";"237840";"157500";"80340"
"1815";"1393293";"2017-04-07";"72902";"2017-04-07";"H-593-15 OTRO SI NRO 003";"309700";"337218";"-27518";"0";"0";"0";"56400";"0";"56400";"0";"337218";"56400";"280818"
"1816";"1396664";"2017-04-07";"72902";"2017-04-07";"H-593-15 OTRO SI NRO 003";"368900";"361522";"7378";"0";"0";"0";"119600";"0";"119600";"0";"361522";"119600";"241922"
"1817";"1398280";"2017-04-07";"72902";"2017-04-07";"H-593-15 OTRO SI NRO 003";"620800";"608384";"12416";"0";"0";"0";"56400";"0";"56400";"0";"608384";"56400";"551984"
"1818";"1388829";"2017-04-07";"72437";"2017-04-07";"H-593-15 OTRO SI NRO 003";"174427";"170938";"3489";"0";"0";"0";"98388";"23688";"74700";"0";"147250";"74700";"72550"
"1819";"1388276";"2017-04-10";"72436";"2017-04-10";"H-593-15 OTRO SI NRO 003";"155900";"152782";"3118";"0";"0";"0";"88000";"13300";"74700";"0";"139482";"74700";"64782"
"1820";"1384168";"2017-04-10";"73202";"2017-04-10";"H-593-15 OTRO SI NRO 003";"95205";"93301";"1904";"0";"0";"0";"35000";"35000";"0";"0";"58301";"35400";"22901"
"1821";"1394050";"2017-04-10";"72844";"2017-04-10";"H-593-15 OTRO SI NRO 003";"168739";"165364";"3375";"0";"0";"0";"88000";"13300";"74700";"0";"152064";"74700";"77364"
"1822";"1396817";"2017-04-10";"72844";"2017-04-10";"H-593-15 OTRO SI NRO 003";"163409";"160141";"3268";"0";"0";"0";"88000";"13300";"74700";"0";"146841";"74700";"72141"
"1823";"1397879";"2017-04-10";"72824";"2017-04-10";"H-593-15 OTRO SI NRO 003";"699975";"685975";"14000";"0";"0";"0";"312670";"125040";"187630";"0";"560935";"187630";"373305"
"1824";"1397917";"2017-04-10";"72824";"2017-04-10";"H-593-15 OTRO SI NRO 003";"761356";"746129";"15227";"0";"0";"0";"230900";"138540";"92360";"0";"607589";"92360";"515229"
"1825";"1383874";"2017-04-10";"72127";"2017-04-10";"H-593-15 OTRO SI NRO 003";"903575";"885503";"18072";"0";"0";"0";"208400";"125040";"83360";"0";"760463";"83360";"677103"
"1826";"1386110";"2017-04-10";"72127";"2017-04-10";"H-593-15 OTRO SI NRO 003";"699975";"685975";"14000";"0";"0";"0";"208400";"125040";"83360";"0";"560935";"83360";"477575"
"1827";"1393599";"2017-04-10";"72843";"2017-04-10";"H-593-15 OTRO SI NRO 003";"786414";"770686";"15728";"0";"0";"0";"311315";"96414";"214901";"0";"674272";"214901";"459371"
"1828";"1383811";"2017-04-10";"72184";"2017-04-10";"H-593-15 OTRO SI NRO 003";"163749";"160474";"3275";"0";"0";"0";"88000";"13300";"74700";"0";"147174";"74700";"72474"
"1829";"1385674";"2017-04-10";"72184";"2017-04-10";"H-593-15 OTRO SI NRO 003";"761356";"746129";"15227";"0";"0";"0";"116500";"69900";"46600";"0";"676229";"46600";"629629"
"1830";"1385737";"2017-04-10";"72184";"2017-04-10";"H-593-15 OTRO SI NRO 003";"439300";"430514";"8786";"0";"0";"0";"208400";"125040";"83360";"0";"305474";"83360";"222114"
"1831";"1386944";"2017-04-10";"72184";"2017-04-10";"H-593-15 OTRO SI NRO 003";"115105";"112803";"2302";"0";"0";"0";"39400";"7736";"31664";"0";"105067";"31664";"73403"
"1832";"1387380";"2017-04-10";"72184";"2017-04-10";"H-593-15 OTRO SI NRO 003";"212830";"208573";"4257";"0";"0";"0";"78750";"0";"78750";"0";"208573";"78750";"129823"
"1833";"1387424";"2017-04-10";"72184";"2017-04-10";"H-593-15 OTRO SI NRO 003";"312900";"340746";"-27846";"0";"0";"0";"266286";"231561";"34725";"0";"109185";"34725";"74460"
"1834";"1387532";"2017-04-10";"72184";"2017-04-10";"H-593-15 OTRO SI NRO 003";"173109";"169647";"3462";"0";"0";"0";"93000";"18300";"74700";"0";"151347";"74700";"76647"
"1835";"1389872";"2017-04-10";"72184";"2017-04-10";"H-593-15 OTRO SI NRO 003";"700315";"686309";"14006";"0";"0";"0";"338738";"125040";"213698";"0";"561269";"213698";"347571"
"1836";"1382795";"2017-04-10";"72707";"2017-04-10";"H-593-15 OTRO SI NRO 003";"789114";"773332";"15782";"0";"0";"0";"311315";"99114";"212201";"0";"674218";"212201";"462017"
"1837";"1395866";"2017-04-10";"72707";"2017-04-10";"H-593-15 OTRO SI NRO 003";"141459";"154114";"-12655";"0";"0";"0";"88000";"13300";"74700";"0";"140814";"74700";"66114"
"1838";"1394915";"2017-04-10";"72675";"2017-04-10";"H-593-15 OTRO SI NRO 003";"699975";"685975";"14000";"0";"0";"0";"312670";"125040";"187630";"0";"560935";"187630";"373305"
"1839";"1383782";"2017-04-10";"72051";"2017-04-10";"H-593-15 OTRO SI NRO 003";"699975";"685975";"14000";"0";"0";"0";"208400";"125040";"83360";"0";"560935";"83360";"477575"
"1840";"1383792";"2017-04-10";"72051";"2017-04-10";"H-593-15 OTRO SI NRO 003";"699975";"685975";"14000";"0";"0";"0";"208400";"125040";"83360";"0";"560935";"83360";"477575"
"1841";"1383894";"2017-04-10";"72051";"2017-04-10";"H-593-15 OTRO SI NRO 003";"107848";"105691";"2157";"0";"0";"0";"39400";"13300";"26100";"0";"92391";"26100";"66291"
"1842";"1384047";"2017-04-10";"72051";"2017-04-10";"H-593-15 OTRO SI NRO 003";"699975";"685975";"14000";"0";"0";"0";"208400";"125040";"83360";"0";"560935";"83360";"477575"
"1843";"1401668";"2017-04-11";"73178";"2017-04-11";"H-852-17";"787625";"771872";"15753";"0";"0";"0";"265290";"223370";"41920";"0";"548502";"41920";"506582"
"1844";"1396994";"2017-05-09";"73615";"2017-05-09";"H-852-17";"333036";"326375";"6661";"0";"0";"0";"2750";"0";"2750";"0";"326375";"2750";"323625"
"1845";"1411320";"2017-05-09";"73615";"2017-05-09";"H-852-17";"810710";"794496";"16214";"0";"0";"0";"2600";"0";"2600";"0";"794496";"2600";"791896"
"1846";"1411586";"2017-05-09";"73615";"2017-05-09";"H-852-17";"751450";"736421";"15029";"0";"0";"0";"8300";"0";"8300";"0";"736421";"8300";"728121"
"1847";"1409286";"2017-05-09";"73812";"2017-05-09";"H-852-17";"107848";"105691";"2157";"0";"0";"0";"39400";"7736";"31664";"0";"97955";"31664";"66291"
"1848";"1409410";"2017-05-09";"73812";"2017-05-09";"H-852-17";"166539";"163208";"3331";"0";"0";"0";"88000";"0";"88000";"0";"163208";"88000";"75208"
"1849";"1411484";"2017-05-09";"73812";"2017-05-09";"H-852-17";"699975";"685975";"14000";"0";"0";"0";"208400";"125000";"83400";"0";"560975";"83400";"477575"
"1850";"1411551";"2017-05-09";"73812";"2017-05-09";"H-852-17";"699975";"685975";"14000";"0";"0";"0";"338738";"177135";"161603";"0";"508840";"161603";"347237"
"1851";"1412366";"2017-05-09";"73812";"2017-05-09";"H-852-17";"903575";"885503";"18072";"0";"0";"0";"338738";"177135";"161603";"0";"708368";"161603";"546765"
"1852";"1412376";"2017-05-09";"73812";"2017-05-09";"H-852-17";"761356";"746129";"15227";"0";"0";"0";"208400";"125000";"83400";"0";"621129";"83400";"537729"
"1853";"1414050";"2017-05-09";"73812";"2017-05-09";"H-852-17";"230114";"225512";"4602";"0";"0";"0";"162300";"0";"162300";"0";"225512";"162300";"63212"
"1854";"1409523";"2017-05-09";"73706";"2017-05-09";"H-852-17";"69018";"67638";"1380";"0";"0";"0";"39400";"7736";"31664";"0";"59902";"31664";"28238"
"1855";"1401785";"2017-05-09";"74043";"2017-05-09";"H-852-17";"46000";"45080";"920";"0";"0";"0";"46000";"0";"46000";"0";"45080";"46000";"-920"
"1856";"1404087";"2017-05-09";"74043";"2017-05-09";"H-852-17";"46000";"45080";"920";"0";"0";"0";"46000";"0";"46000";"0";"45080";"46000";"-920"
"1857";"1406510";"2017-05-09";"74043";"2017-05-09";"H-852-17";"35000";"34300";"700";"0";"0";"0";"35000";"0";"35000";"0";"34300";"35000";"-700"
"1858";"1411342";"2017-05-09";"74043";"2017-05-09";"H-852-17";"70000";"68600";"1400";"0";"0";"0";"70000";"0";"70000";"0";"68600";"70000";"-1400"
"1859";"1404620";"2017-05-09";"73319";"2017-05-09";"H-852-17";"854301";"837215";"17086";"0";"0";"0";"118410";"102560";"15850";"0";"734655";"15850";"718805"
"1861";"1415230";"2017-05-09";"74160";"2017-05-09";"H-852-17";"796350";"806099";"-9749";"0";"0";"0";"71250";"0";"71250";"0";"806099";"71250";"734849"
"1862";"1411760";"2017-05-09";"73317";"2017-05-09";"H-852-17";"880411";"862803";"17608";"0";"0";"0";"135910";"102560";"33350";"0";"760243";"33350";"726893"
"1863";"1406116";"2017-05-09";"74045";"2017-05-09";"H-852-17";"786614";"770882";"15732";"0";"0";"0";"311315";"99114";"212201";"0";"671768";"212201";"459567"
"1864";"1410024";"2017-05-09";"74045";"2017-05-09";"H-852-17";"70000";"68600";"1400";"0";"0";"0";"70000";"0";"70000";"0";"68600";"70000";"-1400"
"1865";"1410081";"2017-05-09";"73522";"2017-05-09";"H-852-17";"104599";"102507";"2092";"0";"0";"0";"39400";"7736";"31664";"0";"94771";"31664";"63107"
"1866";"1401012";"2017-05-09";"73384";"2017-05-09";"H-852-17";"786274";"770549";"15725";"0";"0";"0";"311315";"99114";"212201";"0";"671435";"212201";"459234"
"1867";"1404609";"2017-05-09";"73384";"2017-05-09";"H-852-17";"56000";"54880";"1120";"0";"0";"0";"56000";"0";"56000";"0";"54880";"56000";"-1120"
"1868";"1413399";"2017-05-09";"74040";"2017-05-09";"H-852-17";"70000";"68600";"1400";"0";"0";"0";"70000";"0";"70000";"0";"68600";"70000";"-1400"
"1869";"1417785";"2017-05-10";"74192";"2017-05-10";"H-852-17";"112201";"109957";"2244";"0";"0";"0";"21771";"6500";"15271";"0";"103457";"15271";"88186"
"1870";"1418009";"2017-05-10";"74192";"2017-05-10";"H-852-17";"112201";"109957";"2244";"0";"0";"0";"21771";"6500";"15271";"0";"103457";"15271";"88186"
"1871";"1418192";"2017-05-10";"74192";"2017-05-10";"H-852-17";"699700";"685706";"13994";"0";"0";"0";"338600";"255200";"83400";"0";"430506";"83400";"347106"
"1872";"1418366";"2017-05-10";"74192";"2017-05-10";"H-852-17";"112201";"109957";"2244";"0";"0";"0";"21771";"6500";"15271";"0";"103457";"15271";"88186"
"1873";"1418726";"2017-05-10";"74192";"2017-05-10";"H-852-17";"112201";"109957";"2244";"0";"0";"0";"112201";"6500";"105701";"0";"103457";"105701";"-2244"
"1874";"1413690";"2017-05-11";"74252";"2017-05-11";"H-852-17";"70000";"68600";"1400";"0";"0";"0";"70000";"0";"70000";"0";"68600";"70000";"-1400"
"1875";"1418357";"2017-05-11";"74252";"2017-05-11";"H-852-17";"439300";"430514";"8786";"0";"0";"0";"208400";"125000";"83400";"0";"305514";"83400";"222114"
"1876";"1419558";"2017-05-11";"74252";"2017-05-11";"H-852-17";"699975";"685975";"14000";"0";"0";"0";"208400";"125000";"83400";"0";"560975";"83400";"477575"
"1877";"1418210";"2017-05-11";"74291";"2017-05-11";"H-852-17";"745000";"730100";"14900";"0";"0";"0";"88900";"0";"88900";"0";"730100";"88900";"641200"
"1878";"1413261";"2017-05-11";"74289";"2017-05-11";"H-852-17";"267890";"262532";"5358";"0";"0";"0";"116600";"0";"116600";"0";"262532";"116600";"145932"
"1879";"1420268";"2017-05-11";"74319";"2017-05-11";"H-852-17";"223264";"218799";"4465";"0";"0";"0";"157500";"0";"157500";"0";"218799";"157500";"61299"
"1880";"1413496";"2017-05-11";"73521";"2017-05-11";"H-852-17";"173109";"169647";"3462";"0";"0";"0";"95500";"0";"95500";"0";"169647";"95500";"74147"
"1881";"1413497";"2017-05-11";"73521";"2017-05-11";"H-852-17";"115105";"112803";"2302";"0";"0";"0";"39400";"0";"39400";"0";"112803";"39400";"73403"
"1882";"1413912";"2017-05-11";"73521";"2017-05-11";"H-852-17";"200014";"218554";"-18540";"0";"0";"0";"157500";"0";"157500";"0";"218554";"157500";"61054"
"1883";"1420420";"2017-05-11";"73521";"2017-05-11";"H-852-17";"439300";"430514";"8786";"0";"0";"0";"208400";"125000";"83400";"0";"305514";"83400";"222114"
"1884";"1427166";"2017-06-13";"75479";"2017-06-13";"H-852-17";"41144345";"26932936";"14211409";"0";"0";"0";"13388522";"4574887";"8813635";"0";"22358049";"7500";"22350549"
"1885";"1442919";"2017-07-07";"75921";"2017-07-07";"H-852-17";"913961";"895682";"18279";"0";"0";"0";"72300";"66800";"5500";"0";"828882";"5500";"823382"
"1886";"1444209";"2017-07-07";"75921";"2017-07-07";"H-852-17";"1865751";"1828436";"37315";"0";"0";"0";"451310";"399360";"51950";"0";"1429076";"51950";"1377126"
"1887";"1469234";"2017-08-09";"77351";"2017-08-09";"H-852-17";"56000";"54880";"1120";"0";"0";"0";"0";"0";"0";"0";"54880";"56000";"-1120"
"1888";"1457551";"2017-08-09";"77239";"2017-08-09";"H-852-17";"35000";"34300";"700";"0";"0";"0";"0";"0";"0";"0";"34300";"35000";"-700"
"1889";"1489223";"2017-09-11";"79147";"2017-09-11";"H-852-17";"6461811";"6332575";"129236";"0";"0";"0";"964562";"959062";"5500";"0";"5373513";"5500";"5368013"
"1890";"1493450";"2017-09-11";"79147";"2017-09-11";"H-852-17";"1157300";"1134154";"23146";"0";"0";"0";"130200";"35000";"95200";"0";"1099154";"95200";"1003954"
"1891";"1515882";"2017-10-09";"80655";"2017-10-09";"H-852-17";"45885747";"44968032";"917715";"0";"0";"0";"13086642";"4495710";"8590932";"0";"40472322";"277695";"40194627"
"1892";"1496172";"2017-10-09";"80608";"2017-10-09";"H-852-17";"3680489";"3606879";"73610";"0";"0";"0";"1116011";"1050987";"65024";"0";"2555892";"65024";"2490868"
"1893";"1525449";"2017-10-09";"80608";"2017-10-09";"H-852-17";"7090487";"6948677";"141810";"0";"0";"0";"1073473";"12330";"1061143";"0";"6936347";"85250";"6851097"
"1894";"1512635";"2017-10-09";"80610";"2017-10-09";"H-852-17";"53761066";"52685845";"1075221";"0";"0";"0";"11440300";"4925470";"6514830";"0";"47760375";"207630";"47552745"
"1895";"1482931";"2017-10-09";"80420";"2017-10-09";"H-852-17";"50373555";"49366084";"1007471";"0";"0";"0";"4946872";"3576348";"1370524";"0";"45789736";"1235224";"44554512"
"1896";"1491422";"2017-10-09";"80420";"2017-10-09";"H-852-17";"2470466";"2421057";"49409";"0";"0";"0";"596700";"200";"596500";"0";"2420857";"596500";"1824357"
"1897";"1523219";"2017-10-09";"80420";"2017-10-09";"H-852-17";"11771141";"11535718";"235423";"0";"0";"0";"3509544";"2117812";"1391732";"0";"9417906";"1391732";"8026174"
"1898";"1493664";"2017-10-09";"79345";"2017-10-09";"H-852-17";"73092154";"71630311";"1461843";"0";"0";"0";"27698812";"4113652";"23585160";"0";"67516659";"21961560";"45555099"
"1899";"1494817";"2017-10-09";"79345";"2017-10-09";"H-852-17";"3432019";"3363379";"68640";"0";"0";"0";"659501";"2601";"656900";"0";"3360778";"656900";"2703878"
"1900";"1521631";"2017-10-09";"80552";"2017-10-09";"H-852-17";"881775";"864139";"17636";"0";"0";"0";"262605";"195705";"66900";"0";"668434";"66900";"601534"
"1901";"1522983";"2017-10-09";"80552";"2017-10-09";"H-852-17";"160060";"156859";"3201";"0";"0";"0";"8650";"0";"8650";"0";"156859";"8650";"148209"
"1902";"1499417";"2017-10-09";"80609";"2017-10-09";"H-852-17";"49446108";"48457186";"988922";"0";"0";"0";"3664623";"378511";"3286112";"0";"48078675";"3286112";"44792563"
"1903";"1498894";"2017-10-09";"80644";"2017-10-09";"H-852-17";"817392";"801044";"16348";"0";"0";"0";"66025";"55175";"10850";"0";"745869";"10850";"735019"
"1904";"1522031";"2017-10-09";"80644";"2017-10-09";"H-852-17";"23293267";"22827402";"465865";"0";"0";"0";"1176957";"389227";"787730";"0";"22438175";"187572";"22250603"
"1905";"1526134";"2017-10-09";"80644";"2017-10-09";"H-852-17";"16425436";"16096927";"328509";"0";"0";"0";"2397449";"0";"2397449";"0";"16096927";"29350";"16067577"
"1906";"1494758";"2017-10-09";"80627";"2017-10-09";"H-852-17";"8665238";"8491933";"173305";"0";"0";"0";"2221115";"1279775";"941340";"0";"7212158";"486940";"6725218"
"1907";"1495093";"2017-10-09";"80627";"2017-10-09";"H-852-17";"10019343";"9818956";"200387";"0";"0";"0";"1832200";"398062";"1434138";"0";"9420894";"1434138";"7986756"
"1908";"1503991";"2017-10-09";"80627";"2017-10-09";"H-852-17";"3079523";"3017933";"61590";"0";"0";"0";"405550";"151750";"253800";"0";"2866183";"253800";"2612383"
"1909";"1522040";"2017-10-09";"80627";"2017-10-09";"H-852-17";"2692849";"2932306";"-239457";"0";"0";"0";"478062";"308862";"169200";"0";"2623444";"169200";"2454244"
"1910";"1528376";"2017-10-09";"80627";"2017-10-09";"H-852-17";"18714869";"18340572";"374297";"0";"0";"0";"921500";"256900";"664600";"0";"18083672";"407700";"17675972"
"1911";"1510970";"2017-10-09";"80607";"2017-10-09";"H-852-17";"18619841";"18247444";"372397";"0";"0";"0";"1997802";"89765";"1908037";"0";"18157679";"1158752";"16998927"
"1912";"1528661";"2017-10-09";"80607";"2017-10-09";"H-852-17";"9164155";"8980872";"183283";"0";"0";"0";"128175";"121900";"6275";"0";"8858972";"6275";"8852697"
"1913";"1528722";"2017-10-09";"80607";"2017-10-09";"H-852-17";"10625579";"10413067";"212512";"0";"0";"0";"2124412";"1330612";"793800";"0";"9082455";"793800";"8288655"
"1914";"1494824";"2017-10-09";"80621";"2017-10-09";"H-852-17";"3457832";"3388675";"69157";"0";"0";"0";"72850";"58700";"14150";"0";"3329975";"14150";"3315825"
"1915";"1506034";"2017-10-09";"80621";"2017-10-09";"H-852-17";"5410074";"5301873";"108201";"0";"0";"0";"91972";"71300";"20672";"0";"5230573";"20672";"5209901"
"1916";"1522333";"2017-10-09";"80621";"2017-10-09";"H-852-17";"1204398";"1180310";"24088";"0";"0";"0";"120750";"71300";"49450";"0";"1109010";"49450";"1059560"
"1917";"1528284";"2017-10-09";"80634";"2017-10-09";"H-852-17";"62595206";"61343302";"1251904";"0";"0";"0";"10734867";"1501091";"9233776";"0";"59842211";"9234300";"50607911"
"1918";"1527854";"2017-10-09";"80528";"2017-10-09";"H-852-17";"2015516";"1975206";"40310";"0";"0";"0";"660878";"64378";"596500";"0";"1910828";"596500";"1314328"
"1919";"1500725";"2017-10-09";"79486";"2017-10-09";"H-852-17";"470680";"461266";"9414";"0";"0";"0";"111500";"44600";"66900";"0";"416666";"66900";"349766"
"1920";"1525074";"2017-10-09";"80443";"2017-10-09";"H-852-17";"827100";"810558";"16542";"0";"0";"0";"468705";"111500";"357205";"0";"699058";"357205";"341853"
"1921";"1495395";"2017-10-09";"80421";"2017-10-09";"H-852-17";"1087236";"1065491";"21745";"0";"0";"0";"60941";"48800";"12141";"0";"1016691";"12141";"1004550"
"1922";"1510725";"2017-10-09";"80421";"2017-10-09";"H-852-17";"2003615";"1963543";"40072";"0";"0";"0";"455820";"120750";"335070";"0";"1842793";"335070";"1507723"
"1923";"1513655";"2017-10-09";"80240";"2017-10-09";"H-852-17";"1461350";"1432123";"29227";"0";"0";"0";"305800";"194300";"111500";"0";"1237823";"111500";"1126323"
"1924";"1514025";"2017-10-09";"80240";"2017-10-09";"H-852-17";"224179";"219695";"4484";"0";"0";"0";"5250";"0";"5250";"0";"219695";"5250";"214445"
"1925";"1518331";"2017-10-09";"79947";"2017-10-09";"H-852-17";"160060";"156859";"3201";"0";"0";"0";"8650";"0";"8650";"0";"156859";"8650";"148209"
"1926";"1527588";"2017-10-09";"80305";"2017-10-09";"H-852-17";"792056";"776215";"15841";"0";"0";"0";"111500";"44600";"66900";"0";"731615";"66900";"664715"
"1927";"1516987";"2017-10-09";"80055";"2017-10-09";"H-852-17";"635230";"691713";"-56483";"0";"0";"0";"15830";"0";"15830";"0";"691713";"15830";"675883"
"1928";"1515325";"2017-10-09";"80280";"2017-10-09";"H-852-17";"223000";"218540";"4460";"0";"0";"0";"111500";"44600";"66900";"0";"173940";"66900";"107040"
"1929";"1510380";"2017-10-09";"79691";"2017-10-09";"H-852-17";"544623";"533731";"10892";"0";"0";"0";"43023";"40803";"2220";"0";"492928";"2220";"490708"
"1930";"1510384";"2017-10-09";"79691";"2017-10-09";"H-852-17";"1064482";"1043192";"21290";"0";"0";"0";"20632";"18412";"2220";"0";"1024780";"2220";"1022560"
"1931";"1510394";"2017-10-09";"79691";"2017-10-09";"H-852-17";"1024611";"1004119";"20492";"0";"0";"0";"524040";"0";"524040";"0";"1004119";"524040";"480079"
"1932";"1510399";"2017-10-09";"79691";"2017-10-09";"H-852-17";"1410311";"1382105";"28206";"0";"0";"0";"145650";"2950";"142700";"0";"1379155";"142700";"1236455"
"1933";"1517543";"2017-10-09";"79691";"2017-10-09";"H-852-17";"422700";"414246";"8454";"0";"0";"0";"14350";"8850";"5500";"0";"405396";"5500";"399896"
"1934";"1519129";"2017-10-09";"79691";"2017-10-09";"H-852-17";"1769361";"1733974";"35387";"0";"0";"0";"759520";"739620";"19900";"0";"994354";"19900";"974454"
"1935";"1519183";"2017-10-09";"79691";"2017-10-09";"H-852-17";"1502515";"1472465";"30050";"0";"0";"0";"33350";"0";"33350";"0";"1472465";"33350";"1439115"
"1936";"1521461";"2017-10-09";"79691";"2017-10-09";"H-852-17";"1365211";"1337907";"27304";"0";"0";"0";"80950";"0";"80950";"0";"1337907";"80950";"1256957"
"1937";"1493813";"2017-10-09";"79354";"2017-10-09";"H-852-17";"3370350";"3489143";"-118793";"0";"0";"0";"1525850";"296220";"1229630";"0";"3192923";"1229630";"1963293"
"1938";"1494351";"2017-10-09";"79354";"2017-10-09";"H-852-17";"1193365";"1169498";"23867";"0";"0";"0";"16000";"0";"16000";"0";"1169498";"16000";"1153498"
"1939";"1495957";"2017-10-09";"79354";"2017-10-09";"H-852-17";"369350";"361963";"7387";"0";"0";"0";"80850";"64850";"16000";"0";"297113";"16000";"281113"
"1940";"1495969";"2017-10-09";"79354";"2017-10-09";"H-852-17";"1202000";"1177960";"24040";"0";"0";"0";"174900";"35000";"139900";"0";"1142960";"139900";"1003060"
"1941";"1510633";"2017-10-09";"79354";"2017-10-09";"H-852-17";"4620616";"4528204";"92412";"0";"0";"0";"867362";"250162";"617200";"0";"4278042";"617200";"3660842"
"1942";"1515398";"2017-10-09";"79354";"2017-10-09";"H-852-17";"556661";"606288";"-49627";"0";"0";"0";"38850";"0";"38850";"0";"606288";"38850";"567438"
"1943";"1515735";"2017-10-09";"79354";"2017-10-09";"H-852-17";"1237511";"1212761";"24750";"0";"0";"0";"657520";"190256";"467264";"0";"1022505";"467264";"555241"
"1944";"1494711";"2017-10-09";"80445";"2017-10-09";"H-852-17";"5571475";"5460045";"111430";"0";"0";"0";"446750";"441250";"5500";"0";"5018795";"5500";"5013295"
"1945";"1519064";"2017-10-09";"80445";"2017-10-09";"H-852-17";"2939501";"2880711";"58790";"0";"0";"0";"54600";"0";"54600";"0";"2880711";"54600";"2826111"
"1946";"1520221";"2017-10-09";"80445";"2017-10-09";"H-852-17";"1617065";"1584724";"32341";"0";"0";"0";"16000";"0";"16000";"0";"1584724";"16000";"1568724"
"1947";"1522713";"2017-10-09";"80445";"2017-10-09";"H-852-17";"1734250";"1699565";"34685";"0";"0";"0";"822430";"193154";"629276";"0";"1506411";"629276";"877135"
"1948";"1524109";"2017-10-09";"80445";"2017-10-09";"H-852-17";"779550";"763959";"15591";"0";"0";"0";"19450";"0";"19450";"0";"763959";"19450";"744509"
"1949";"1524159";"2017-10-09";"80445";"2017-10-09";"H-852-17";"918265";"899900";"18365";"0";"0";"0";"2650";"0";"2650";"0";"899900";"2650";"897250"
"1950";"1524496";"2017-10-09";"80445";"2017-10-09";"H-852-17";"1495111";"1465209";"29902";"0";"0";"0";"297361";"0";"297361";"0";"1465209";"297361";"1167848"
"1951";"1526388";"2017-10-09";"80445";"2017-10-09";"H-852-17";"1670800";"1637384";"33416";"0";"0";"0";"432100";"0";"432100";"0";"1637384";"432100";"1205284"
"1952";"1516186";"2017-10-09";"79351";"2017-10-09";"H-852-17";"152900";"149842";"3058";"0";"0";"0";"37000";"0";"37000";"0";"149842";"37000";"112842"
"1953";"1516199";"2017-10-09";"79351";"2017-10-09";"H-852-17";"117490";"115140";"2350";"0";"0";"0";"22200";"0";"22200";"0";"115140";"22200";"92940"
"1954";"1516250";"2017-10-09";"79351";"2017-10-09";"H-852-17";"131750";"129115";"2635";"0";"0";"0";"10050";"3500";"6550";"0";"125615";"6550";"119065"
"1955";"1519375";"2017-10-09";"79351";"2017-10-09";"H-852-17";"38692";"37918";"774";"0";"0";"0";"9692";"0";"9692";"0";"37918";"9692";"28226"
"1956";"1519389";"2017-10-09";"79351";"2017-10-09";"H-852-17";"63700";"62426";"1274";"0";"0";"0";"8300";"1750";"6550";"0";"60676";"6550";"54126"
"1957";"1519392";"2017-10-09";"79351";"2017-10-09";"H-852-17";"160981";"157761";"3220";"0";"0";"0";"6651";"0";"6651";"0";"157761";"6651";"151110"
"1958";"1519456";"2017-10-09";"79351";"2017-10-09";"H-852-17";"183136";"179473";"3663";"0";"0";"0";"2300";"0";"2300";"0";"179473";"2300";"177173"
"1959";"1519459";"2017-10-09";"79351";"2017-10-09";"H-852-17";"167180";"163836";"3344";"0";"0";"0";"10240";"0";"10240";"0";"163836";"10240";"153596"
"1960";"1519464";"2017-10-09";"79351";"2017-10-09";"H-852-17";"446225";"437300";"8925";"0";"0";"0";"5050";"0";"5050";"0";"437300";"5050";"432250"
"1961";"1494475";"2017-10-09";"80633";"2017-10-09";"H-852-17";"440022";"431222";"8800";"0";"0";"0";"156450";"0";"156450";"0";"431222";"156450";"274772"
"1962";"1525517";"2017-10-09";"80633";"2017-10-09";"H-852-17";"1136737";"1114002";"22735";"0";"0";"0";"136147";"51420";"84727";"0";"1062582";"84727";"977855"
"1963";"1525856";"2017-10-09";"80633";"2017-10-09";"H-852-17";"7929755";"7771160";"158595";"0";"0";"0";"100386";"29850";"70536";"0";"7741310";"70536";"7670774"
"1964";"1527968";"2017-10-09";"80633";"2017-10-09";"H-852-17";"4126696";"4044162";"82534";"0";"0";"0";"871801";"549000";"322801";"0";"3495162";"65801";"3429361"
"1965";"1529341";"2017-10-09";"80633";"2017-10-09";"H-852-17";"3452960";"3383901";"69059";"0";"0";"0";"165977";"154977";"11000";"0";"3228924";"11000";"3217924"
"1966";"1529365";"2017-10-09";"80633";"2017-10-09";"H-852-17";"3194680";"3130786";"63894";"0";"0";"0";"442212";"433312";"8900";"0";"2697474";"8900";"2688574"
"1967";"1529480";"2017-10-09";"80633";"2017-10-09";"H-852-17";"2759000";"2703820";"55180";"0";"0";"0";"171500";"87600";"83900";"0";"2616220";"83900";"2532320"
"1968";"1530440";"2017-10-10";"80582";"2017-10-10";"H-852-17";"870050";"852649";"17401";"0";"0";"0";"71250";"0";"71250";"0";"852649";"71250";"781399"
"1969";"1531044";"2017-10-10";"80582";"2017-10-10";"H-852-17";"2431711";"2383077";"48634";"0";"0";"0";"1092000";"1021400";"70600";"0";"1361677";"70600";"1291077"
"1970";"1532637";"2017-10-10";"80582";"2017-10-10";"H-852-17";"942300";"923454";"18846";"0";"0";"0";"540640";"535140";"5500";"0";"388314";"5900";"382414"
"1971";"1533400";"2017-10-10";"80582";"2017-10-10";"H-852-17";"1134000";"1111320";"22680";"0";"0";"0";"5500";"0";"5500";"0";"1111320";"5500";"1105820"
"1972";"1521685";"2017-10-10";"80583";"2017-10-10";"H-852-17";"700530";"686519";"14011";"0";"0";"0";"10530";"0";"10530";"0";"686519";"10530";"675989"
"1973";"1528317";"2017-10-10";"80583";"2017-10-10";"H-852-17";"731540";"716909";"14631";"0";"0";"0";"223000";"111500";"111500";"0";"605409";"111500";"493909"
"1974";"1510603";"2017-10-10";"80732";"2017-10-10";"H-852-17";"3084992";"3023292";"61700";"0";"0";"0";"194651";"171991";"22660";"0";"2851301";"22660";"2828641"
"1975";"1521518";"2017-10-10";"80732";"2017-10-10";"H-852-17";"1179986";"1156386";"23600";"0";"0";"0";"5232";"1332";"3900";"0";"1155054";"3900";"1151154"
"1976";"1524680";"2017-10-10";"80732";"2017-10-10";"H-852-17";"16865391";"16528083";"337308";"0";"0";"0";"533205";"158755";"374450";"0";"16369328";"374450";"15994878"
"1977";"1469028";"2017-10-10";"79746";"2017-10-10";"H-852-17";"17709862";"16827249";"882613";"0";"0";"0";"2921166";"669977";"2251189";"0";"16157272";"365976";"15791296"
"1978";"1478808";"2017-10-10";"79746";"2017-10-10";"H-852-17";"2925423";"2866915";"58508";"0";"0";"0";"757240";"741500";"15740";"0";"2125415";"15740";"2109675"
"1979";"1496745";"2017-10-10";"79746";"2017-10-10";"H-852-17";"3033587";"2972915";"60672";"0";"0";"0";"658550";"0";"658550";"0";"2972915";"658550";"2314365"
"1980";"1509743";"2017-10-10";"79746";"2017-10-10";"H-852-17";"650733";"637718";"13015";"0";"0";"0";"41450";"38800";"2650";"0";"598918";"2650";"596268"
"1981";"1515069";"2017-10-10";"79746";"2017-10-10";"H-852-17";"8422685";"8254231";"168454";"0";"0";"0";"1024026";"615220";"408806";"0";"7639011";"132856";"7506155"
"1982";"1495371";"2017-10-10";"80684";"2017-10-10";"H-852-17";"29814625";"29218332";"596293";"0";"0";"0";"3809553";"1083764";"2725789";"0";"28134568";"1305600";"26828968"
"1983";"1507360";"2017-10-10";"80660";"2017-10-10";"H-852-17";"59364227";"58176942";"1187285";"0";"0";"0";"9052349";"8004264";"1048085";"0";"50172678";"298800";"49873878"
"1984";"1524801";"2017-10-10";"80658";"2017-10-10";"H-852-17";"86378586";"84651014";"1727572";"0";"0";"0";"8651732";"3804685";"4847047";"0";"80846329";"606900";"80239429"
"1985";"1508839";"2017-10-10";"80667";"2017-10-10";"H-852-17";"25776476";"25260946";"515530";"0";"0";"0";"3957803";"1303845";"2653958";"0";"23957101";"2053800";"21903301"
"1986";"1514519";"2017-10-10";"80667";"2017-10-10";"H-852-17";"29531477";"28940847";"590630";"0";"0";"0";"3142108";"1061058";"2081050";"0";"27879789";"1604900";"26274889"
"1987";"1529300";"2017-10-10";"78872";"2017-10-10";"H-852-17";"5155995";"5052875";"103120";"0";"0";"0";"2078346";"1954866";"123480";"0";"3098009";"123480";"2974529"
"1988";"1531972";"2017-10-10";"80643";"2017-10-10";"H-852-17";"199200";"195216";"3984";"0";"0";"0";"120300";"60150";"60150";"0";"135066";"60150";"74916"
"1989";"1533066";"2017-10-10";"80643";"2017-10-10";"H-852-17";"470000";"460600";"9400";"0";"0";"0";"124700";"0";"124700";"0";"460600";"124700";"335900"
"1990";"1533068";"2017-10-10";"80643";"2017-10-10";"H-852-17";"948575";"929603";"18972";"0";"0";"0";"329505";"44600";"284905";"0";"885003";"284905";"600098"
"1991";"1533091";"2017-10-10";"80643";"2017-10-10";"H-852-17";"730675";"716061";"14614";"0";"0";"0";"111500";"44600";"66900";"0";"671461";"66900";"604561"
"1992";"1521704";"2017-10-10";"80759";"2017-10-10";"H-852-17";"700530";"686519";"14011";"0";"0";"0";"10530";"0";"10530";"0";"686519";"10530";"675989"
"1993";"1521899";"2017-10-10";"80661";"2017-10-10";"H-852-17";"1431792";"1403156";"28636";"0";"0";"0";"129200";"74050";"55150";"0";"1329106";"55150";"1273956"
"1994";"1524958";"2017-10-10";"80661";"2017-10-10";"H-852-17";"25613520";"25101250";"512270";"0";"0";"0";"3342753";"1748897";"1593856";"0";"23352353";"134500";"23217853"
"1995";"1528621";"2017-10-10";"80661";"2017-10-10";"H-852-17";"14880673";"14583060";"297613";"0";"0";"0";"1799481";"503158";"1296323";"0";"14079902";"856723";"13223179"
"1996";"1503780";"2017-10-10";"80727";"2017-10-10";"H-852-17";"19717367";"19323020";"394347";"0";"0";"0";"2045646";"505650";"1539996";"0";"18817370";"110533";"18706837"
"1997";"1535136";"2017-11-10";"81168";"2017-11-10";"H-852-17";"1627300";"1594754";"32546";"0";"0";"0";"600200";"102902";"497298";"0";"1491852";"497298";"994554"
"1998";"1536415";"2017-11-10";"81168";"2017-11-10";"H-852-17";"996465";"976536";"19929";"0";"0";"0";"52050";"3450";"48600";"0";"973086";"48600";"924486"
"1999";"1536627";"2017-11-10";"81270";"2017-11-10";"H-852-17";"1516200";"1485876";"30324";"0";"0";"0";"556500";"111300";"445200";"0";"1374576";"445200";"929376"
"2000";"1541386";"2017-11-10";"81270";"2017-11-10";"H-852-17";"7067747";"6926392";"141355";"0";"0";"0";"4750600";"4316062";"434538";"0";"2610330";"434538";"2175792"
"2001";"1543296";"2017-11-10";"81270";"2017-11-10";"H-852-17";"293800";"287924";"5876";"0";"0";"0";"51000";"35000";"16000";"0";"252924";"16000";"236924"
"2002";"1546220";"2017-11-10";"81270";"2017-11-10";"H-852-17";"743515";"728645";"14870";"0";"0";"0";"16000";"0";"16000";"0";"728645";"16000";"712645"
"2003";"1546263";"2017-11-10";"81270";"2017-11-10";"H-852-17";"1682400";"1648752";"33648";"0";"0";"0";"894220";"234640";"659580";"0";"1414112";"659580";"754532"
"2004";"1532278";"2017-11-10";"80800";"2017-11-10";"H-852-17";"104200";"102116";"2084";"0";"0";"0";"6600";"0";"6600";"0";"102116";"6600";"95516"
"2005";"1533153";"2017-11-10";"80800";"2017-11-10";"H-852-17";"263428";"258159";"5269";"0";"0";"0";"13100";"0";"13100";"0";"258159";"13100";"245059"
"2006";"1537853";"2017-11-10";"80800";"2017-11-10";"H-852-17";"339830";"333033";"6797";"0";"0";"0";"31290";"0";"31290";"0";"333033";"31290";"301743"
"2007";"1539447";"2017-11-10";"80800";"2017-11-10";"H-852-17";"542778";"531922";"10856";"0";"0";"0";"8500";"0";"8500";"0";"531922";"8500";"523422"
"2008";"1539450";"2017-11-10";"80800";"2017-11-10";"H-852-17";"67202";"65858";"1344";"0";"0";"0";"3842";"0";"3842";"0";"65858";"3842";"62016"
"2009";"1552641";"2017-11-10";"81749";"2017-11-10";"H-852-17";"184210";"180526";"3684";"0";"0";"0";"30600";"0";"30600";"0";"180526";"30600";"149926"
"2010";"1553245";"2017-11-10";"81749";"2017-11-10";"H-852-17";"99095";"97113";"1982";"0";"0";"0";"37700";"0";"37700";"0";"97113";"37700";"59413"
"2011";"1480335";"2017-11-10";"81327";"2017-11-10";"H-852-17";"11836570";"11334651";"501919";"0";"0";"0";"2479350";"978612";"1500738";"0";"10356039";"1309138";"9046901"
"2012";"1493721";"2017-11-10";"81327";"2017-11-10";"H-852-17";"2982991";"2394915";"588076";"0";"0";"0";"255800";"0";"255800";"0";"2394915";"255800";"2139115"
"2013";"1479397";"2017-11-10";"81692";"2017-11-10";"H-852-17";"4424140";"3807241";"616899";"0";"0";"0";"458958";"203158";"255800";"0";"3604083";"255800";"3348283"
"2014";"1479398";"2017-11-10";"81692";"2017-11-10";"H-852-17";"3684392";"3082288";"602104";"0";"0";"0";"255800";"0";"255800";"0";"3082288";"255800";"2826488"
"2015";"1535935";"2017-11-10";"81480";"2017-11-10";"H-852-17";"2605622";"2553510";"52112";"0";"0";"0";"579800";"0";"579800";"0";"2553510";"579800";"1973710"
"2016";"1536540";"2017-11-10";"81480";"2017-11-10";"H-852-17";"2605622";"2553510";"52112";"0";"0";"0";"579800";"0";"579800";"0";"2553510";"579800";"1973710"
"2017";"1551849";"2017-11-10";"81939";"2017-11-10";"H-852-17";"3433877";"3365199";"68678";"0";"0";"0";"1333579";"369089";"964490";"0";"2996110";"964490";"2031620"
"2018";"1557215";"2017-11-10";"82027";"2017-11-10";"H-852-17";"573400";"561932";"11468";"0";"0";"0";"262443";"0";"262443";"0";"561932";"262443";"299489"
"2019";"1546522";"2017-11-10";"81923";"2017-11-10";"H-852-17";"2272400";"2226952";"45448";"0";"0";"0";"1038955";"704455";"334500";"0";"1522497";"334500";"1187997"
"2020";"1548096";"2017-11-10";"81923";"2017-11-10";"H-852-17";"730675";"716061";"14614";"0";"0";"0";"223000";"0";"223000";"0";"716061";"223000";"493061"
"2021";"1548802";"2017-11-10";"81923";"2017-11-10";"H-852-17";"730675";"716061";"14614";"0";"0";"0";"223000";"0";"223000";"0";"716061";"223000";"493061"
"2022";"1551665";"2017-11-10";"81923";"2017-11-10";"H-852-17";"147828";"144871";"2957";"0";"0";"0";"0";"0";"0";"0";"144871";"147828";"-2957"
"2023";"1515893";"2017-11-10";"80851";"2017-11-10";"H-852-17";"240113";"235311";"4802";"0";"0";"0";"128511";"0";"128511";"0";"235311";"128511";"106800"
"2024";"1545375";"2017-11-10";"81460";"2017-11-10";"H-852-17";"250951";"245932";"5019";"0";"0";"0";"250951";"0";"250951";"0";"245932";"250951";"-5019"
"2025";"1553888";"2017-11-14";"80874";"2017-11-14";"H-852-17";"2617072";"2564731";"52341";"0";"0";"0";"579800";"0";"579800";"0";"2564731";"579800";"1984931"
"2026";"1550364";"2017-11-14";"82387";"2017-11-14";"H-852-17";"176137";"172614";"3523";"0";"0";"0";"10388";"0";"10388";"0";"172614";"10388";"162226"
"2027";"1553892";"2017-11-14";"82452";"2017-11-14";"H-852-17";"3192214";"3128370";"63844";"0";"0";"0";"202050";"42450";"159600";"0";"3085920";"159600";"2926320"
"2028";"1554136";"2017-11-14";"82452";"2017-11-14";"H-852-17";"6565706";"6434392";"131314";"0";"0";"0";"1840950";"472342";"1368608";"0";"5962050";"1368608";"4593442"
"2029";"1554246";"2017-11-14";"82452";"2017-11-14";"H-852-17";"11574700";"11343206";"231494";"0";"0";"0";"199500";"0";"199500";"0";"11343206";"199500";"11143706"
"2030";"1556425";"2017-11-14";"82452";"2017-11-14";"H-852-17";"23102861";"22640804";"462057";"0";"0";"0";"2576416";"803537";"1772879";"0";"21837267";"582900";"21254367"
"2031";"1541718";"2017-11-14";"82453";"2017-11-14";"H-852-17";"6139219";"6016435";"122784";"0";"0";"0";"431068";"194258";"236810";"0";"5822177";"101510";"5720667"
"2032";"1542689";"2017-11-14";"82469";"2017-11-14";"H-852-17";"53348256";"52281291";"1066965";"0";"0";"0";"8512158";"1387774";"7124384";"0";"50893517";"6014330";"44879187"
"2033";"1556732";"2017-11-14";"82469";"2017-11-14";"H-852-17";"3115238";"3052933";"62305";"0";"0";"0";"94600";"0";"94600";"0";"3052933";"94600";"2958333"
"2034";"1556769";"2017-11-14";"82469";"2017-11-14";"H-852-17";"1853247";"1816182";"37065";"0";"0";"0";"68600";"51200";"17400";"0";"1764982";"17400";"1747582"
"2035";"1556005";"2017-11-14";"82454";"2017-11-14";"H-852-17";"2352417";"2305369";"47048";"0";"0";"0";"274878";"225700";"49178";"0";"2079669";"49178";"2030491"
"2036";"1533451";"2017-11-14";"82126";"2017-11-14";"H-852-17";"207818";"203662";"4156";"0";"0";"0";"3800";"0";"3800";"0";"203662";"3800";"199862"
"2037";"1556433";"2017-11-14";"82126";"2017-11-14";"H-852-17";"172500";"169050";"3450";"0";"0";"0";"15900";"0";"15900";"0";"169050";"15900";"153150"
"2038";"1545154";"2017-11-14";"81413";"2017-11-14";"H-852-17";"1040170";"1019367";"20803";"0";"0";"0";"2600";"0";"2600";"0";"1019367";"2600";"1016767"
"2039";"1552903";"2017-11-14";"81413";"2017-11-14";"H-852-17";"2057482";"2016332";"41150";"0";"0";"0";"1716300";"1076400";"639900";"0";"939932";"639900";"300032"
"2040";"1533747";"2017-11-14";"81793";"2017-11-14";"H-852-17";"4198411";"4114443";"83968";"0";"0";"0";"624300";"54700";"569600";"0";"4059743";"569600";"3490143"
"2041";"1530764";"2017-11-14";"81691";"2017-11-14";"H-852-17";"15762935";"15447676";"315259";"0";"0";"0";"3533000";"521012";"3011988";"0";"14926664";"3011988";"11914676"
"2042";"1534193";"2017-11-14";"82363";"2017-11-14";"H-852-17";"12306546";"12060415";"246131";"0";"0";"0";"5404700";"4535624";"869076";"0";"7524791";"869076";"6655715"
"2043";"1546649";"2017-11-14";"82363";"2017-11-14";"H-852-17";"15144690";"14841796";"302894";"0";"0";"0";"2860755";"471100";"2389655";"0";"14370696";"89400";"14281296"
"2044";"1547996";"2017-11-14";"82363";"2017-11-14";"H-852-17";"10946014";"10727094";"218920";"0";"0";"0";"4886700";"4452162";"434538";"0";"6274932";"434538";"5840394"
"2045";"1540691";"2017-11-14";"82366";"2017-11-14";"H-852-17";"10939910";"10721112";"218798";"0";"0";"0";"920650";"264400";"656250";"0";"10456712";"51850";"10404862"
"2046";"1553573";"2017-11-14";"82366";"2017-11-14";"H-852-17";"866116";"848794";"17322";"0";"0";"0";"5000";"0";"5000";"0";"848794";"5000";"843794"
"2047";"1540889";"2017-11-14";"82364";"2017-11-14";"H-852-17";"34043301";"33362435";"680866";"0";"0";"0";"3860483";"843637";"3016846";"0";"32518798";"973974";"31544824"
"2048";"1551048";"2017-11-14";"82364";"2017-11-14";"H-852-17";"14502680";"14212626";"290054";"0";"0";"0";"3545516";"2217688";"1327828";"0";"11994938";"1012538";"10982400"
"2049";"1553270";"2017-11-14";"82364";"2017-11-14";"H-852-17";"13007087";"12746945";"260142";"0";"0";"0";"3075000";"2640462";"434538";"0";"10106483";"434538";"9671945"
"2050";"1541060";"2017-11-14";"82427";"2017-11-14";"H-852-17";"3720151";"3645748";"74403";"0";"0";"0";"1672650";"1238112";"434538";"0";"2407636";"434538";"1973098"
"2051";"1542008";"2017-11-14";"82427";"2017-11-14";"H-852-17";"23262006";"22796766";"465240";"0";"0";"0";"1319344";"617294";"702050";"0";"22179472";"702050";"21477422"
"2052";"1544999";"2017-11-14";"82427";"2017-11-14";"H-852-17";"16568751";"16237376";"331375";"0";"0";"0";"2069950";"1635412";"434538";"0";"14601964";"434538";"14167426"
"2053";"1542892";"2017-11-14";"82365";"2017-11-14";"H-852-17";"34984881";"34285183";"699698";"0";"0";"0";"2292562";"1910870";"381692";"0";"32374313";"52134";"32322179"
"2054";"1550637";"2017-11-14";"82365";"2017-11-14";"H-852-17";"15944053";"15625172";"318881";"0";"0";"0";"1665958";"1534328";"131630";"0";"14090844";"131630";"13959214"
"2055";"1555592";"2017-11-14";"82458";"2017-11-14";"H-852-17";"4287982";"4202222";"85760";"0";"0";"0";"357000";"14000";"343000";"0";"4188222";"343000";"3845222"
"2056";"1544240";"2017-11-15";"82428";"2017-11-15";"H-852-17";"20203411";"19799343";"404068";"0";"0";"0";"3291481";"1320774";"1970707";"0";"18478569";"911900";"17566669"
"2057";"1555624";"2017-11-15";"82451";"2017-11-15";"H-852-17";"5008839";"4908662";"100177";"0";"0";"0";"1021196";"437100";"584096";"0";"4471562";"322056";"4149506"
"2058";"1556469";"2017-11-15";"82451";"2017-11-15";"H-852-17";"24818036";"24321675";"496361";"0";"0";"0";"13296614";"1439532";"11857082";"0";"22882143";"11721782";"11160361"
"2059";"1556471";"2017-11-15";"82451";"2017-11-15";"H-852-17";"9448404";"9259436";"188968";"0";"0";"0";"4105323";"2067808";"2037515";"0";"7191628";"2037515";"5154113"
"2060";"1536035";"2017-12-11";"82911";"2017-12-11";"H-852-17";"2489530";"2439739";"49791";"0";"0";"0";"120730";"97000";"23730";"0";"2342739";"23730";"2319009"
"2061";"1560486";"2017-12-11";"82911";"2017-12-11";"H-852-17";"29714095";"29119813";"594282";"0";"0";"0";"1196615";"724027";"472588";"0";"28395786";"143030";"28252756"
"2062";"1562996";"2017-12-11";"82911";"2017-12-11";"H-852-17";"16340927";"16014108";"326819";"0";"0";"0";"1064649";"419727";"644922";"0";"15594381";"11064";"15583317"
"2063";"1563211";"2017-12-11";"82530";"2017-12-11";"H-852-17";"635080";"622378";"12702";"0";"0";"0";"67397";"0";"67397";"0";"622378";"67397";"554981"
"2064";"1565605";"2017-12-11";"82530";"2017-12-11";"H-852-17";"765620";"750308";"15312";"0";"0";"0";"4736";"0";"4736";"0";"750308";"4736";"745572"
"2065";"1565626";"2017-12-11";"82530";"2017-12-11";"H-852-17";"823030";"806569";"16461";"0";"0";"0";"4736";"0";"4736";"0";"806569";"4736";"801833"
"2066";"1567368";"2017-12-11";"82530";"2017-12-11";"H-852-17";"1998257";"1958292";"39965";"0";"0";"0";"20601";"0";"20601";"0";"1958292";"20601";"1937691"
"2067";"1567769";"2017-12-11";"82530";"2017-12-11";"H-852-17";"598514";"586544";"11970";"0";"0";"0";"20601";"0";"20601";"0";"586544";"20601";"565943"
"2068";"1568958";"2017-12-11";"82530";"2017-12-11";"H-852-17";"1017221";"1107617";"-90396";"0";"0";"0";"25337";"0";"25337";"0";"1107617";"25337";"1082280"
"2069";"1571851";"2017-12-11";"82530";"2017-12-11";"H-852-17";"2153237";"2110172";"43065";"0";"0";"0";"4736";"0";"4736";"0";"2110172";"4736";"2105436"
"2070";"1575958";"2017-12-11";"82530";"2017-12-11";"H-852-17";"308320";"302154";"6166";"0";"0";"0";"20601";"0";"20601";"0";"302154";"20601";"281553"
"2071";"1562719";"2017-12-11";"82912";"2017-12-11";"H-852-17";"37330082";"36583480";"746602";"0";"0";"0";"3717042";"616827";"3100215";"0";"35966653";"306457";"35660196"
"2072";"1576203";"2017-12-11";"83745";"2017-12-11";"H-852-17";"66890";"65552";"1338";"0";"0";"0";"8277";"0";"8277";"0";"65552";"8277";"57275"
"2073";"1582486";"2017-12-11";"83745";"2017-12-11";"H-852-17";"62740";"61485";"1255";"0";"0";"0";"4736";"0";"4736";"0";"61485";"4736";"56749"
"2074";"1583651";"2017-12-11";"83745";"2017-12-11";"H-852-17";"450322";"441316";"9006";"0";"0";"0";"9962";"0";"9962";"0";"441316";"9962";"431354"
"2075";"1584105";"2017-12-11";"83745";"2017-12-11";"H-852-17";"102505";"100455";"2050";"0";"0";"0";"24540";"0";"24540";"0";"100455";"24540";"75915"
"2076";"1562956";"2017-12-11";"83292";"2017-12-11";"H-852-17";"118240";"115875";"2365";"0";"0";"0";"12008";"0";"12008";"0";"115875";"12008";"103867"
"2077";"1563022";"2017-12-11";"83292";"2017-12-11";"H-852-17";"71690";"70256";"1434";"0";"0";"0";"9962";"0";"9962";"0";"70256";"9962";"60294"
"2078";"1563047";"2017-12-11";"83292";"2017-12-11";"H-852-17";"65790";"64474";"1316";"0";"0";"0";"8277";"0";"8277";"0";"64474";"8277";"56197"
"2079";"1575903";"2017-12-11";"83292";"2017-12-11";"H-852-17";"774462";"758973";"15489";"0";"0";"0";"9962";"0";"9962";"0";"758973";"9962";"749011"
"2080";"1575940";"2017-12-11";"83292";"2017-12-11";"H-852-17";"740388";"725580";"14808";"0";"0";"0";"116570";"0";"116570";"0";"725580";"116570";"609010"
"2081";"1575994";"2017-12-11";"83292";"2017-12-11";"H-852-17";"431428";"422799";"8629";"0";"0";"0";"9962";"0";"9962";"0";"422799";"9962";"412837"
"2082";"1577285";"2017-12-11";"83292";"2017-12-11";"H-852-17";"237542";"232791";"4751";"0";"0";"0";"17234";"0";"17234";"0";"232791";"17234";"215557"
"2083";"1578512";"2017-12-11";"83292";"2017-12-11";"H-852-17";"142536";"139685";"2851";"0";"0";"0";"9962";"0";"9962";"0";"139685";"9962";"129723"
"2084";"1578515";"2017-12-11";"83292";"2017-12-11";"H-852-17";"76855";"75318";"1537";"0";"0";"0";"12008";"0";"12008";"0";"75318";"12008";"63310"
"2085";"1578517";"2017-12-11";"83292";"2017-12-11";"H-852-17";"94180";"92296";"1884";"0";"0";"0";"9962";"0";"9962";"0";"92296";"9962";"82334"
"2086";"1578526";"2017-12-11";"83292";"2017-12-11";"H-852-17";"62118";"60876";"1242";"0";"0";"0";"4736";"0";"4736";"0";"60876";"4736";"56140"
"2087";"1579014";"2017-12-11";"83292";"2017-12-11";"H-852-17";"1973021";"1933561";"39460";"0";"0";"0";"9962";"0";"9962";"0";"1933561";"9962";"1923599"
"2088";"1579499";"2017-12-11";"83292";"2017-12-11";"H-852-17";"408292";"400126";"8166";"0";"0";"0";"32293";"0";"32293";"0";"400126";"32293";"367833"
"2089";"1580328";"2017-12-11";"83292";"2017-12-11";"H-852-17";"131802";"129166";"2636";"0";"0";"0";"4736";"0";"4736";"0";"129166";"4736";"124430"
"2090";"1580851";"2017-12-11";"83292";"2017-12-11";"H-852-17";"41200";"40376";"824";"0";"0";"0";"4736";"0";"4736";"0";"40376";"4736";"35640"
"2091";"1569277";"2017-12-11";"83761";"2017-12-11";"H-852-17";"18845285";"18468379";"376906";"0";"0";"0";"1938946";"759388";"1179558";"0";"17708991";"850000";"16858991"
"2092";"1574873";"2017-12-11";"83951";"2017-12-11";"H-852-17";"5052249";"4951204";"101045";"0";"0";"0";"897221";"485159";"412062";"0";"4466045";"82504";"4383541"
"2093";"1576548";"2017-12-11";"83951";"2017-12-11";"H-852-17";"10804048";"10587967";"216081";"0";"0";"0";"11430";"0";"11430";"0";"10587967";"11430";"10576537"
"2094";"1581429";"2017-12-11";"83951";"2017-12-11";"H-852-17";"42660751";"41807536";"853215";"0";"0";"0";"2898838";"2200538";"698300";"0";"39606998";"368742";"39238256"
"2095";"1571977";"2017-12-12";"83861";"2017-12-12";"H-852-17";"274200";"268716";"5484";"0";"0";"0";"22200";"0";"22200";"0";"268716";"22200";"246516"
"2096";"1565208";"2017-12-12";"82647";"2017-12-12";"H-852-17";"274200";"268716";"5484";"0";"0";"0";"22200";"0";"22200";"0";"268716";"22200";"246516"
"2097";"1565221";"2017-12-12";"82647";"2017-12-12";"H-852-17";"548400";"537432";"10968";"0";"0";"0";"44400";"0";"44400";"0";"537432";"44400";"493032"
"2098";"1565177";"2017-12-12";"83743";"2017-12-12";"H-852-17";"274200";"268716";"5484";"0";"0";"0";"22200";"0";"22200";"0";"268716";"22200";"246516"
"2099";"1572371";"2017-12-12";"83743";"2017-12-12";"H-852-17";"548400";"537432";"10968";"0";"0";"0";"44400";"0";"44400";"0";"537432";"44400";"493032"
"2100";"1581798";"2017-12-12";"83743";"2017-12-12";"H-852-17";"274200";"268716";"5484";"0";"0";"0";"22200";"0";"22200";"0";"268716";"22200";"246516"
"2101";"1578851";"2017-12-12";"83511";"2017-12-12";"H-852-17";"180000";"176400";"3600";"0";"0";"0";"54000";"0";"54000";"0";"176400";"54000";"122400"
"2102";"1580957";"2017-12-12";"83511";"2017-12-12";"H-852-17";"180000";"176400";"3600";"0";"0";"0";"54000";"0";"54000";"0";"176400";"54000";"122400"
"2103";"1574306";"2017-12-12";"83224";"2017-12-12";"H-852-17";"274200";"268716";"5484";"0";"0";"0";"22200";"0";"22200";"0";"268716";"22200";"246516"
"2104";"1574446";"2017-12-12";"83224";"2017-12-12";"H-852-17";"274200";"268716";"5484";"0";"0";"0";"22200";"0";"22200";"0";"268716";"22200";"246516"
"2105";"1575922";"2017-12-12";"83224";"2017-12-12";"H-852-17";"274200";"268716";"5484";"0";"0";"0";"22200";"0";"22200";"0";"268716";"22200";"246516"
"2106";"1575925";"2017-12-12";"83224";"2017-12-12";"H-852-17";"274200";"268716";"5484";"0";"0";"0";"22200";"0";"22200";"0";"268716";"22200";"246516"
"2107";"1568740";"2017-12-12";"83084";"2017-12-12";"H-852-17";"252000";"246960";"5040";"0";"0";"0";"17600";"0";"17600";"0";"246960";"17600";"229360"
"2108";"1568741";"2017-12-12";"83084";"2017-12-12";"H-852-17";"504000";"493920";"10080";"0";"0";"0";"35200";"0";"35200";"0";"493920";"35200";"458720"
"2109";"1572060";"2017-12-12";"83084";"2017-12-12";"H-852-17";"274200";"268716";"5484";"0";"0";"0";"39800";"0";"39800";"0";"268716";"39800";"228916"
"2110";"1572075";"2017-12-12";"83084";"2017-12-12";"H-852-17";"548400";"537432";"10968";"0";"0";"0";"79600";"0";"79600";"0";"537432";"79600";"457832"
"2111";"1572876";"2017-12-12";"83084";"2017-12-12";"H-852-17";"147500";"144550";"2950";"0";"0";"0";"8800";"0";"8800";"0";"144550";"8800";"135750"
"2112";"1572889";"2017-12-12";"83084";"2017-12-12";"H-852-17";"274200";"268716";"5484";"0";"0";"0";"39800";"0";"39800";"0";"268716";"39800";"228916"
"2113";"1562295";"2017-12-12";"82581";"2017-12-12";"H-852-17";"70000";"68600";"1400";"0";"0";"0";"24000";"0";"24000";"0";"68600";"24000";"44600"
"2114";"1563491";"2017-12-12";"82581";"2017-12-12";"H-852-17";"180000";"176400";"3600";"0";"0";"0";"54000";"0";"54000";"0";"176400";"54000";"122400"
"2115";"1563745";"2017-12-12";"82581";"2017-12-12";"H-852-17";"70000";"68600";"1400";"0";"0";"0";"24000";"0";"24000";"0";"68600";"24000";"44600"
"2116";"1563766";"2017-12-12";"82581";"2017-12-12";"H-852-17";"180000";"176400";"3600";"0";"0";"0";"54000";"0";"54000";"0";"176400";"54000";"122400"
"2117";"1565949";"2017-12-12";"82883";"2017-12-12";"H-852-17";"274200";"268716";"5484";"0";"0";"0";"17600";"0";"17600";"0";"268716";"17600";"251116"
"2118";"1566970";"2017-12-12";"82883";"2017-12-12";"H-852-17";"274200";"268716";"5484";"0";"0";"0";"17600";"0";"17600";"0";"268716";"17600";"251116"
"2119";"1566980";"2017-12-12";"82883";"2017-12-12";"H-852-17";"169700";"166306";"3394";"0";"0";"0";"8800";"0";"8800";"0";"166306";"8800";"157506"
"2120";"1568194";"2017-12-12";"82883";"2017-12-12";"H-852-17";"147500";"144550";"2950";"0";"0";"0";"8800";"0";"8800";"0";"144550";"8800";"135750"
"2121";"1569086";"2017-12-12";"82883";"2017-12-12";"H-852-17";"234524";"229834";"4690";"0";"0";"0";"47250";"0";"47250";"0";"229834";"47250";"182584"
"2122";"1569824";"2017-12-12";"82883";"2017-12-12";"H-852-17";"70000";"68600";"1400";"0";"0";"0";"24000";"0";"24000";"0";"68600";"24000";"44600"
"2123";"1561819";"2017-12-12";"82871";"2017-12-12";"H-852-17";"10257279";"10052133";"205146";"0";"0";"0";"2413830";"0";"2413830";"0";"10052133";"2413830";"7638303"
"2124";"1586238";"2017-12-12";"84118";"2017-12-12";"H-852-17";"180000";"176400";"3600";"0";"0";"0";"54000";"0";"54000";"0";"176400";"54000";"122400"
"2125";"1585263";"2017-12-12";"84004";"2017-12-12";"H-852-17";"70000";"68600";"1400";"0";"0";"0";"27500";"0";"27500";"0";"68600";"27500";"41100"
"2126";"1585812";"2017-12-12";"84004";"2017-12-12";"H-852-17";"61700";"60466";"1234";"0";"0";"0";"11430";"0";"11430";"0";"60466";"11430";"49036"
"2127";"1571017";"2017-12-12";"84157";"2017-12-12";"H-852-17";"147500";"144550";"2950";"0";"0";"0";"8800";"0";"8800";"0";"144550";"8800";"135750"
"2128";"1571051";"2017-12-12";"84157";"2017-12-12";"H-852-17";"274200";"268716";"5484";"0";"0";"0";"57400";"0";"57400";"0";"268716";"57400";"211316"
"2129";"1571068";"2017-12-12";"84157";"2017-12-12";"H-852-17";"274200";"268716";"5484";"0";"0";"0";"39800";"0";"39800";"0";"268716";"39800";"228916"
"2130";"1574235";"2017-12-12";"84157";"2017-12-12";"H-852-17";"274200";"268716";"5484";"0";"0";"0";"39800";"0";"39800";"0";"268716";"39800";"228916"
"2131";"1587539";"2017-12-12";"84157";"2017-12-12";"H-852-17";"1171575";"1148143";"23432";"0";"0";"0";"223000";"111500";"111500";"0";"1036643";"111500";"925143"
"2132";"1584908";"2017-12-12";"84033";"2017-12-12";"H-852-17";"3482000";"3412360";"69640";"0";"0";"0";"413500";"0";"413500";"0";"3412360";"413500";"2998860"
"2133";"1585839";"2017-12-12";"84033";"2017-12-12";"H-852-17";"6030111";"5909509";"120602";"0";"0";"0";"726300";"0";"726300";"0";"5909509";"726300";"5183209"
"2134";"1571911";"2017-12-12";"83254";"2017-12-12";"H-852-17";"274200";"268716";"5484";"0";"0";"0";"22200";"0";"22200";"0";"268716";"22200";"246516"
"2135";"1573964";"2017-12-12";"83254";"2017-12-12";"H-852-17";"180000";"176400";"3600";"0";"0";"0";"54000";"0";"54000";"0";"176400";"54000";"122400"
"2136";"1573969";"2017-12-12";"83254";"2017-12-12";"H-852-17";"180000";"176400";"3600";"0";"0";"0";"54000";"0";"54000";"0";"176400";"54000";"122400"
"2137";"1575479";"2017-12-12";"83254";"2017-12-12";"H-852-17";"274200";"268716";"5484";"0";"0";"0";"22200";"0";"22200";"0";"268716";"22200";"246516"
"2138";"1575491";"2017-12-12";"83254";"2017-12-12";"H-852-17";"274200";"268716";"5484";"0";"0";"0";"22200";"0";"22200";"0";"268716";"22200";"246516"
"2139";"1565593";"2017-12-12";"82648";"2017-12-12";"H-852-17";"1298000";"1272040";"25960";"0";"0";"0";"24800";"0";"24800";"0";"1272040";"24800";"1247240"
"2140";"1560285";"2017-12-12";"83964";"2017-12-12";"H-852-17";"70433";"69024";"1409";"0";"0";"0";"43400";"500";"42900";"0";"68524";"42900";"25624"
"2141";"1573314";"2017-12-12";"83930";"2017-12-12";"H-852-17";"274200";"268716";"5484";"0";"0";"0";"22200";"0";"22200";"0";"268716";"22200";"246516"
"2142";"1573316";"2017-12-12";"83930";"2017-12-12";"H-852-17";"274200";"268716";"5484";"0";"0";"0";"22200";"0";"22200";"0";"268716";"22200";"246516"
"2143";"1575476";"2017-12-12";"83930";"2017-12-12";"H-852-17";"274200";"268716";"5484";"0";"0";"0";"22200";"0";"22200";"0";"268716";"22200";"246516"
"2144";"1580143";"2017-12-12";"83930";"2017-12-12";"H-852-17";"274200";"268716";"5484";"0";"0";"0";"22200";"0";"22200";"0";"268716";"22200";"246516"
"2145";"1584229";"2017-12-12";"83930";"2017-12-12";"H-852-17";"180000";"176400";"3600";"0";"0";"0";"54000";"0";"54000";"0";"176400";"54000";"122400"
"2146";"1584506";"2017-12-12";"83930";"2017-12-12";"H-852-17";"180000";"176400";"3600";"0";"0";"0";"54000";"0";"54000";"0";"176400";"54000";"122400"
"2147";"1568042";"2017-12-12";"83449";"2017-12-12";"H-852-17";"274200";"268716";"5484";"0";"0";"0";"22200";"0";"22200";"0";"268716";"22200";"246516"
"2148";"1568189";"2017-12-12";"83449";"2017-12-12";"H-852-17";"232200";"268716";"-36516";"0";"0";"0";"22200";"0";"22200";"0";"268716";"22200";"246516"
"2149";"1568192";"2017-12-12";"83449";"2017-12-12";"H-852-17";"548400";"537432";"10968";"0";"0";"0";"44400";"0";"44400";"0";"537432";"44400";"493032"
"2150";"1578758";"2017-12-12";"83449";"2017-12-12";"H-852-17";"274200";"268716";"5484";"0";"0";"0";"22200";"0";"22200";"0";"268716";"22200";"246516"
"2151";"1571210";"2017-12-12";"83041";"2017-12-12";"H-852-17";"111600";"109368";"2232";"0";"0";"0";"18187";"0";"18187";"0";"109368";"18187";"91181"
"2152";"1567660";"2017-12-12";"82985";"2017-12-12";"H-852-17";"180000";"176400";"3600";"0";"0";"0";"46800";"0";"46800";"0";"176400";"46800";"129600"
"2153";"1572381";"2017-12-12";"83327";"2017-12-12";"H-852-17";"438800";"411624";"27176";"0";"0";"0";"18400";"0";"18400";"0";"411624";"18400";"393224"
"2154";"1577198";"2017-12-12";"83327";"2017-12-12";"H-852-17";"147500";"135750";"11750";"0";"0";"0";"8800";"0";"8800";"0";"135750";"8800";"126950"
"2155";"1577690";"2017-12-12";"83327";"2017-12-12";"H-852-17";"246200";"200916";"45284";"0";"0";"0";"39800";"0";"39800";"0";"200916";"39800";"161116"
"2156";"1561894";"2017-12-12";"82491";"2017-12-12";"H-852-17";"180000";"176400";"3600";"0";"0";"0";"54000";"0";"54000";"0";"176400";"54000";"122400"
"2157";"1564982";"2017-12-12";"82686";"2017-12-12";"H-852-17";"274200";"268716";"5484";"0";"0";"0";"22200";"0";"22200";"0";"268716";"22200";"246516"
"2158";"1565348";"2017-12-12";"82686";"2017-12-12";"H-852-17";"70000";"68600";"1400";"0";"0";"0";"21000";"0";"21000";"0";"68600";"21000";"47600"
"2159";"1566039";"2017-12-12";"82686";"2017-12-12";"H-852-17";"90000";"88200";"1800";"0";"0";"0";"44000";"0";"44000";"0";"88200";"44000";"44200"
"2160";"1566147";"2017-12-12";"82686";"2017-12-12";"H-852-17";"180000";"176400";"3600";"0";"0";"0";"54000";"0";"54000";"0";"176400";"54000";"122400"
"2161";"1553136";"2017-12-12";"83770";"2017-12-12";"H-852-17";"274200";"268716";"5484";"0";"0";"0";"39800";"0";"39800";"0";"268716";"39800";"228916"
"2162";"1554561";"2017-12-12";"83770";"2017-12-12";"H-852-17";"274200";"268716";"5484";"0";"0";"0";"39800";"0";"39800";"0";"268716";"39800";"228916"
"2163";"1580655";"2017-12-12";"83770";"2017-12-12";"H-852-17";"180000";"176400";"3600";"0";"0";"0";"54000";"0";"54000";"0";"176400";"54000";"122400"
"2164";"1567265";"2017-12-12";"83650";"2017-12-12";"H-852-17";"274200";"268716";"5484";"0";"0";"0";"22200";"0";"22200";"0";"268716";"22200";"246516"
"2165";"1580204";"2017-12-12";"83650";"2017-12-12";"H-852-17";"339400";"332612";"6788";"0";"0";"0";"44400";"0";"44400";"0";"332612";"44400";"288212"
"2166";"1581198";"2017-12-12";"83650";"2017-12-12";"H-852-17";"180000";"176400";"3600";"0";"0";"0";"54000";"0";"54000";"0";"176400";"54000";"122400"
"2167";"1570361";"2017-12-12";"83304";"2017-12-12";"H-852-17";"56000";"54880";"1120";"0";"0";"0";"10000";"0";"10000";"0";"54880";"10000";"44880"
"2168";"1574743";"2017-12-12";"83304";"2017-12-12";"H-852-17";"274200";"268716";"5484";"0";"0";"0";"22200";"0";"22200";"0";"268716";"22200";"246516"
"2169";"1575292";"2017-12-12";"83304";"2017-12-12";"H-852-17";"274200";"268716";"5484";"0";"0";"0";"22200";"0";"22200";"0";"268716";"22200";"246516"
"2170";"1564856";"2017-12-12";"82784";"2017-12-12";"H-852-17";"548400";"537432";"10968";"0";"0";"0";"44400";"0";"44400";"0";"537432";"44400";"493032"
"2171";"1565751";"2017-12-12";"82784";"2017-12-12";"H-852-17";"46000";"45080";"920";"0";"0";"0";"11000";"0";"11000";"0";"45080";"11000";"34080"
"2172";"1565813";"2017-12-12";"82784";"2017-12-12";"H-852-17";"274200";"268716";"5484";"0";"0";"0";"22200";"0";"22200";"0";"268716";"22200";"246516"
"2173";"1567078";"2017-12-12";"82784";"2017-12-12";"H-852-17";"180000";"176400";"3600";"0";"0";"0";"54000";"0";"54000";"0";"176400";"54000";"122400"
"2174";"1568018";"2017-12-12";"82784";"2017-12-12";"H-852-17";"180000";"176400";"3600";"0";"0";"0";"54000";"0";"54000";"0";"176400";"54000";"122400"
"2175";"1568020";"2017-12-12";"82784";"2017-12-12";"H-852-17";"180000";"176400";"3600";"0";"0";"0";"54000";"0";"54000";"0";"176400";"54000";"122400"
"2176";"1568348";"2017-12-12";"83150";"2017-12-12";"H-852-17";"339400";"332612";"6788";"0";"0";"0";"17600";"0";"17600";"0";"332612";"17600";"315012"
"2177";"1572983";"2017-12-12";"83150";"2017-12-12";"H-852-17";"70000";"68600";"1400";"0";"0";"0";"41800";"0";"41800";"0";"68600";"41800";"26800"
"2178";"1567020";"2017-12-12";"83411";"2017-12-12";"H-852-17";"274200";"268716";"5484";"0";"0";"0";"17600";"0";"17600";"0";"268716";"17600";"251116"
"2179";"1567026";"2017-12-12";"83411";"2017-12-12";"H-852-17";"147500";"144550";"2950";"0";"0";"0";"8800";"0";"8800";"0";"144550";"8800";"135750"
"2180";"1567041";"2017-12-12";"83411";"2017-12-12";"H-852-17";"548400";"537432";"10968";"0";"0";"0";"35200";"0";"35200";"0";"537432";"35200";"502232"
"2181";"1573504";"2017-12-12";"83411";"2017-12-12";"H-852-17";"300000";"294000";"6000";"0";"0";"0";"244000";"0";"244000";"0";"294000";"244000";"50000"
"2182";"1573508";"2017-12-12";"83411";"2017-12-12";"H-852-17";"300000";"294000";"6000";"0";"0";"0";"244000";"0";"244000";"0";"294000";"244000";"50000"
"2183";"1573515";"2017-12-12";"83411";"2017-12-12";"H-852-17";"300000";"294000";"6000";"0";"0";"0";"244000";"0";"244000";"0";"294000";"244000";"50000"
"2184";"1573524";"2017-12-12";"83411";"2017-12-12";"H-852-17";"300000";"294000";"6000";"0";"0";"0";"244000";"0";"244000";"0";"294000";"244000";"50000"
"2185";"1573773";"2017-12-12";"83411";"2017-12-12";"H-852-17";"300000";"294000";"6000";"0";"0";"0";"244000";"0";"244000";"0";"294000";"244000";"50000"
"2186";"1573777";"2017-12-12";"83411";"2017-12-12";"H-852-17";"300000";"294000";"6000";"0";"0";"0";"244000";"0";"244000";"0";"294000";"244000";"50000"
"2187";"1577473";"2017-12-12";"83411";"2017-12-12";"H-852-17";"61700";"60466";"1234";"0";"0";"0";"35716";"0";"35716";"0";"60466";"35716";"24750"
"2188";"1577616";"2017-12-12";"83411";"2017-12-12";"H-852-17";"274200";"268716";"5484";"0";"0";"0";"17600";"0";"17600";"0";"268716";"17600";"251116"
"2189";"1578086";"2017-12-12";"83411";"2017-12-12";"H-852-17";"180000";"176400";"3600";"0";"0";"0";"54000";"0";"54000";"0";"176400";"54000";"122400"
"2190";"1568990";"2017-12-14";"84244";"2017-12-14";"H-852-17";"274200";"268716";"5484";"0";"0";"0";"22200";"0";"22200";"0";"268716";"22200";"246516"
"2191";"1586457";"2017-12-14";"84244";"2017-12-14";"H-852-17";"180000";"176400";"3600";"0";"0";"0";"54000";"0";"54000";"0";"176400";"54000";"122400"
"2192";"1586468";"2017-12-14";"84244";"2017-12-14";"H-852-17";"180000";"176400";"3600";"0";"0";"0";"54000";"0";"54000";"0";"176400";"54000";"122400"
"2193";"1604626";"2018-01-20";"85237";"2018-01-20";"H-852-17";"46000";"45080";"920";"0";"0";"0";"46000";"0";"46000";"0";"45080";"46000";"-920"
"2194";"1604789";"2018-01-20";"85288";"2018-01-20";"H-852-17";"4567725";"3948170";"619555";"0";"0";"0";"4567725";"237690";"4330035";"0";"3710480";"12902";"3697578"
"2195";"1604293";"2018-01-20";"85395";"2018-01-20";"H-852-17";"7763950";"4604857";"3159093";"0";"0";"0";"3003814";"1277100";"1726714";"0";"3327757";"1726714";"1601043"
"2196";"1588775";"2018-01-23";"84544";"2018-01-23";"H-852-17";"4604425";"4512336";"92089";"0";"0";"0";"4604425";"1841770";"2762655";"0";"2670566";"92089";"2578477"
"2197";"1619006";"2018-02-12";"86629";"2018-02-12";"H-852-17   OTROSI NRO 001";"1344900";"817622";"527278";"0";"0";"0";"500380";"12600";"487780";"0";"805022";"487780";"317242"
"2198";"1613263";"2018-02-12";"86473";"2018-02-12";"H-852-17   OTROSI NRO 001";"1155849";"903655";"252194";"0";"0";"0";"229077";"621";"228456";"0";"903034";"228456";"674578"
"2199";"1615005";"2018-02-12";"86473";"2018-02-12";"H-852-17   OTROSI NRO 001";"21207825";"11707565";"9500260";"0";"0";"0";"9076103";"5212488";"3863615";"0";"6495077";"3863615";"2631462"
"2200";"1615107";"2018-02-12";"86473";"2018-02-12";"H-852-17   OTROSI NRO 001";"25781557";"23456984";"2324573";"0";"0";"0";"1808942";"852852";"956090";"0";"22604132";"816155";"21787977"
"2201";"1618294";"2018-02-13";"86718";"2018-02-13";"H-852-17   OTROSI NRO 001";"27945145";"19909599";"8035546";"0";"0";"0";"7468843";"1435540";"6033303";"0";"18474059";"6033303";"12440756"
"2202";"1620924";"2018-02-13";"86718";"2018-02-13";"H-852-17   OTROSI NRO 001";"3452032";"2742141";"709891";"0";"0";"0";"640850";"291012";"349838";"0";"2451129";"349838";"2101291"
"2203";"1621326";"2018-02-13";"86718";"2018-02-13";"H-852-17   OTROSI NRO 001";"11796674";"8735976";"3060698";"0";"0";"0";"2824765";"1006727";"1818038";"0";"7729249";"1818038";"5911211"
"2204";"1615035";"2018-02-13";"86400";"2018-02-13";"H-852-17   OTROSI NRO 001";"810000";"669600";"140400";"0";"0";"0";"124200";"0";"124200";"0";"669600";"124200";"545400"
"2205";"1610055";"2018-02-13";"86472";"2018-02-13";"H-852-17   OTROSI NRO 001";"8246238";"6155707";"2090531";"0";"0";"0";"1925606";"1031571";"894035";"0";"5124136";"894035";"4230101"
"2206";"1615856";"2018-02-13";"86472";"2018-02-13";"H-852-17   OTROSI NRO 001";"2064546";"1418055";"646491";"0";"0";"0";"605200";"98250";"506950";"0";"1319805";"506950";"812855"
"2207";"1616794";"2018-02-13";"86472";"2018-02-13";"H-852-17   OTROSI NRO 001";"11735390";"11421932";"313458";"0";"0";"0";"78750";"0";"78750";"0";"11421932";"78750";"11343182"
"2208";"1616964";"2018-02-13";"86472";"2018-02-13";"H-852-17   OTROSI NRO 001";"11600389";"7998481";"3601908";"0";"0";"0";"3369900";"482870";"2887030";"0";"7515611";"2887030";"4628581"
"2209";"1618126";"2018-02-13";"86472";"2018-02-13";"H-852-17   OTROSI NRO 001";"3818642";"3091269";"727373";"0";"0";"0";"651000";"476081";"174919";"0";"2615188";"174919";"2440269"
"2210";"1633953";"2018-03-09";"87943";"2018-03-09";"H-852-17   OTROSI NRO 001";"274200";"268716";"5484";"0";"0";"0";"0";"0";"0";"0";"268716";"274200";"-5484"
"2211";"1636667";"2018-03-09";"87943";"2018-03-09";"H-852-17   OTROSI NRO 001";"274200";"268716";"5484";"0";"0";"0";"0";"0";"0";"0";"268716";"274200";"-5484"
"2212";"1637430";"2018-03-09";"87943";"2018-03-09";"H-852-17   OTROSI NRO 001";"548400";"537432";"10968";"0";"0";"0";"0";"0";"0";"0";"537432";"548400";"-10968"
"2213";"1644653";"2018-03-09";"87943";"2018-03-09";"H-852-17   OTROSI NRO 001";"178000";"174440";"3560";"0";"0";"0";"0";"0";"0";"0";"174440";"178000";"-3560"
"2214";"1644706";"2018-03-09";"87943";"2018-03-09";"H-852-17   OTROSI NRO 001";"70000";"68600";"1400";"0";"0";"0";"0";"0";"0";"0";"68600";"70000";"-1400"
"2215";"1644802";"2018-03-09";"87943";"2018-03-09";"H-852-17   OTROSI NRO 001";"56000";"54880";"1120";"0";"0";"0";"0";"0";"0";"0";"54880";"56000";"-1120"
"2216";"1645251";"2018-03-09";"87943";"2018-03-09";"H-852-17   OTROSI NRO 001";"56000";"54880";"1120";"0";"0";"0";"0";"0";"0";"0";"54880";"56000";"-1120"
"2217";"1645438";"2018-03-09";"87943";"2018-03-09";"H-852-17   OTROSI NRO 001";"56000";"54880";"1120";"0";"0";"0";"0";"0";"0";"0";"54880";"56000";"-1120"
"2218";"1645467";"2018-03-09";"87943";"2018-03-09";"H-852-17   OTROSI NRO 001";"46000";"45080";"920";"0";"0";"0";"0";"0";"0";"0";"45080";"46000";"-920"
"2219";"1645471";"2018-03-09";"87943";"2018-03-09";"H-852-17   OTROSI NRO 001";"56000";"54880";"1120";"0";"0";"0";"0";"0";"0";"0";"54880";"56000";"-1120"
"2220";"1645494";"2018-03-09";"87943";"2018-03-09";"H-852-17   OTROSI NRO 001";"46000";"45080";"920";"0";"0";"0";"0";"0";"0";"0";"45080";"46000";"-920"
"2221";"1645635";"2018-03-09";"87943";"2018-03-09";"H-852-17   OTROSI NRO 001";"46000";"45080";"920";"0";"0";"0";"0";"0";"0";"0";"45080";"46000";"-920"
"2222";"1645679";"2018-03-09";"87943";"2018-03-09";"H-852-17   OTROSI NRO 001";"46000";"45080";"920";"0";"0";"0";"0";"0";"0";"0";"45080";"46000";"-920"
"2223";"1645850";"2018-03-09";"87943";"2018-03-09";"H-852-17   OTROSI NRO 001";"35000";"34300";"700";"0";"0";"0";"0";"0";"0";"0";"34300";"35000";"-700"
"2224";"1645879";"2018-03-09";"87943";"2018-03-09";"H-852-17   OTROSI NRO 001";"35000";"34300";"700";"0";"0";"0";"0";"0";"0";"0";"34300";"35000";"-700"
"2225";"1645880";"2018-03-09";"87943";"2018-03-09";"H-852-17   OTROSI NRO 001";"46000";"45080";"920";"0";"0";"0";"0";"0";"0";"0";"45080";"46000";"-920"
"2226";"1645997";"2018-03-09";"87943";"2018-03-09";"H-852-17   OTROSI NRO 001";"35900";"35182";"718";"0";"0";"0";"0";"0";"0";"0";"35182";"35900";"-718"
"2227";"1646002";"2018-03-09";"87943";"2018-03-09";"H-852-17   OTROSI NRO 001";"46000";"45080";"920";"0";"0";"0";"0";"0";"0";"0";"45080";"46000";"-920"
"2228";"1646010";"2018-03-09";"87943";"2018-03-09";"H-852-17   OTROSI NRO 001";"46000";"45080";"920";"0";"0";"0";"0";"0";"0";"0";"45080";"46000";"-920"
"2229";"1646028";"2018-03-09";"87943";"2018-03-09";"H-852-17   OTROSI NRO 001";"46000";"45080";"920";"0";"0";"0";"0";"0";"0";"0";"45080";"46000";"-920"
"2230";"1646034";"2018-03-09";"87943";"2018-03-09";"H-852-17   OTROSI NRO 001";"46000";"45080";"920";"0";"0";"0";"0";"0";"0";"0";"45080";"46000";"-920"
"2231";"1646057";"2018-03-09";"87943";"2018-03-09";"H-852-17   OTROSI NRO 001";"70000";"68600";"1400";"0";"0";"0";"0";"0";"0";"0";"68600";"70000";"-1400"
"2232";"1646070";"2018-03-09";"87943";"2018-03-09";"H-852-17   OTROSI NRO 001";"56000";"54880";"1120";"0";"0";"0";"0";"0";"0";"0";"54880";"56000";"-1120"
"2233";"1646071";"2018-03-09";"87943";"2018-03-09";"H-852-17   OTROSI NRO 001";"70000";"68600";"1400";"0";"0";"0";"0";"0";"0";"0";"68600";"70000";"-1400"
"2234";"1646094";"2018-03-09";"87943";"2018-03-09";"H-852-17   OTROSI NRO 001";"35000";"34300";"700";"0";"0";"0";"0";"0";"0";"0";"34300";"35000";"-700"
"2235";"1646200";"2018-03-09";"87943";"2018-03-09";"H-852-17   OTROSI NRO 001";"35000";"34300";"700";"0";"0";"0";"0";"0";"0";"0";"34300";"35000";"-700"
"2236";"1646250";"2018-03-09";"87943";"2018-03-09";"H-852-17   OTROSI NRO 001";"180000";"176400";"3600";"0";"0";"0";"0";"0";"0";"0";"176400";"180000";"-3600"
"2237";"1605823";"2018-03-09";"88285";"2018-03-09";"H-852-17";"19099465";"18717476";"381989";"0";"0";"0";"870588";"485836";"384752";"0";"18231640";"18228877";"2763"
"2238";"1632274";"2018-03-09";"88053";"2018-03-09";"H-852-17   OTROSI NRO 001";"482931";"473272";"9659";"0";"0";"0";"0";"0";"0";"0";"473272";"482931";"-9659"
"2239";"1646329";"2018-03-09";"88053";"2018-03-09";"H-852-17   OTROSI NRO 001";"313100";"306838";"6262";"0";"0";"0";"0";"0";"0";"0";"306838";"313100";"-6262"
"2240";"1646722";"2018-03-09";"88053";"2018-03-09";"H-852-17   OTROSI NRO 001";"1532511";"1501861";"30650";"0";"0";"0";"642280";"35300";"606980";"0";"1466561";"606980";"859581"
"2241";"1640626";"2018-03-09";"87940";"2018-03-09";"H-852-17   OTROSI NRO 001";"1206700";"1182566";"24134";"0";"0";"0";"0";"0";"0";"0";"1182566";"1206700";"-24134"
"2242";"1640833";"2018-03-09";"87940";"2018-03-09";"H-852-17   OTROSI NRO 001";"152300";"149254";"3046";"0";"0";"0";"0";"0";"0";"0";"149254";"152300";"-3046"
"2243";"1634102";"2018-03-09";"87725";"2018-03-09";"H-852-17   OTROSI NRO 001";"18543253";"18172388";"370865";"0";"0";"0";"2233960";"666803";"1567157";"0";"17505585";"1567157";"15938428"
"2244";"1635190";"2018-03-09";"87725";"2018-03-09";"H-852-17   OTROSI NRO 001";"39082600";"38300948";"781652";"0";"0";"0";"4200225";"1481190";"2719035";"0";"36819758";"874750";"35945008"
"2245";"1626870";"2018-03-09";"87866";"2018-03-09";"H-852-17   OTROSI NRO 001";"221405";"211212";"10193";"0";"0";"0";"5765";"3015";"2750";"0";"208197";"2750";"205447"
"2246";"1632621";"2018-03-09";"87866";"2018-03-09";"H-852-17   OTROSI NRO 001";"357900";"291942";"65958";"0";"0";"0";"58800";"0";"58800";"0";"291942";"58800";"233142"
"2247";"1637830";"2018-03-09";"87866";"2018-03-09";"H-852-17   OTROSI NRO 001";"1077500";"954010";"123490";"0";"0";"0";"101940";"79690";"22250";"0";"874320";"22250";"852070"
"2248";"1645281";"2018-03-09";"87866";"2018-03-09";"H-852-17   OTROSI NRO 001";"1192812";"1168956";"23856";"0";"0";"0";"1192812";"0";"1192812";"0";"1168956";"1192812";"-23856"
"2249";"1647539";"2018-03-09";"87866";"2018-03-09";"H-852-17   OTROSI NRO 001";"1036549";"184918";"851631";"0";"0";"0";"830900";"19900";"811000";"0";"165018";"811000";"-645982"
"2250";"1635396";"2018-03-09";"87779";"2018-03-09";"H-852-17   OTROSI NRO 001";"46000";"45080";"920";"0";"0";"0";"0";"0";"0";"0";"45080";"46000";"-920"
"2251";"1635397";"2018-03-09";"87779";"2018-03-09";"H-852-17   OTROSI NRO 001";"46000";"45080";"920";"0";"0";"0";"0";"0";"0";"0";"45080";"46000";"-920"
"2252";"1635398";"2018-03-09";"87779";"2018-03-09";"H-852-17   OTROSI NRO 001";"46000";"45080";"920";"0";"0";"0";"0";"0";"0";"0";"45080";"46000";"-920"
"2253";"1635399";"2018-03-09";"87779";"2018-03-09";"H-852-17   OTROSI NRO 001";"35000";"34300";"700";"0";"0";"0";"0";"0";"0";"0";"34300";"35000";"-700"
"2254";"1639139";"2018-03-09";"87779";"2018-03-09";"H-852-17   OTROSI NRO 001";"46000";"45080";"920";"0";"0";"0";"0";"0";"0";"0";"45080";"46000";"-920"
"2255";"1639622";"2018-03-09";"87779";"2018-03-09";"H-852-17   OTROSI NRO 001";"46000";"45080";"920";"0";"0";"0";"0";"0";"0";"0";"45080";"46000";"-920"
"2256";"1639801";"2018-03-09";"87779";"2018-03-09";"H-852-17   OTROSI NRO 001";"243833";"238956";"4877";"0";"0";"0";"0";"0";"0";"0";"238956";"243833";"-4877"
"2257";"1639825";"2018-03-09";"87779";"2018-03-09";"H-852-17   OTROSI NRO 001";"46000";"45080";"920";"0";"0";"0";"0";"0";"0";"0";"45080";"46000";"-920"
"2258";"1639842";"2018-03-09";"87779";"2018-03-09";"H-852-17   OTROSI NRO 001";"70000";"68600";"1400";"0";"0";"0";"0";"0";"0";"0";"68600";"70000";"-1400"
"2259";"1639971";"2018-03-09";"87779";"2018-03-09";"H-852-17   OTROSI NRO 001";"46000";"45080";"920";"0";"0";"0";"0";"0";"0";"0";"45080";"46000";"-920"
"2260";"1639977";"2018-03-09";"87779";"2018-03-09";"H-852-17   OTROSI NRO 001";"46000";"45080";"920";"0";"0";"0";"0";"0";"0";"0";"45080";"46000";"-920"
"2261";"1640029";"2018-03-09";"87779";"2018-03-09";"H-852-17   OTROSI NRO 001";"46000";"45080";"920";"0";"0";"0";"0";"0";"0";"0";"45080";"46000";"-920"
"2262";"1640966";"2018-03-09";"87779";"2018-03-09";"H-852-17   OTROSI NRO 001";"17090";"16748";"342";"0";"0";"0";"0";"0";"0";"0";"16748";"17090";"-342"
"2263";"1641701";"2018-03-09";"87779";"2018-03-09";"H-852-17   OTROSI NRO 001";"35000";"34300";"700";"0";"0";"0";"0";"0";"0";"0";"34300";"35000";"-700"
"2264";"1641710";"2018-03-09";"87779";"2018-03-09";"H-852-17   OTROSI NRO 001";"35000";"34300";"700";"0";"0";"0";"0";"0";"0";"0";"34300";"35000";"-700"
"2265";"1641828";"2018-03-09";"87779";"2018-03-09";"H-852-17   OTROSI NRO 001";"112201";"109957";"2244";"0";"0";"0";"0";"0";"0";"0";"109957";"112201";"-2244"
"2266";"1641831";"2018-03-09";"87779";"2018-03-09";"H-852-17   OTROSI NRO 001";"138964";"136185";"2779";"0";"0";"0";"0";"0";"0";"0";"136185";"138964";"-2779"
"2267";"1641833";"2018-03-09";"87779";"2018-03-09";"H-852-17   OTROSI NRO 001";"46000";"45080";"920";"0";"0";"0";"0";"0";"0";"0";"45080";"46000";"-920"
"2268";"1641837";"2018-03-09";"87779";"2018-03-09";"H-852-17   OTROSI NRO 001";"70000";"68600";"1400";"0";"0";"0";"0";"0";"0";"0";"68600";"70000";"-1400"
"2269";"1641880";"2018-03-09";"87779";"2018-03-09";"H-852-17   OTROSI NRO 001";"180000";"176400";"3600";"0";"0";"0";"0";"0";"0";"0";"176400";"180000";"-3600"
"2270";"1641897";"2018-03-09";"87779";"2018-03-09";"H-852-17   OTROSI NRO 001";"46000";"45080";"920";"0";"0";"0";"0";"0";"0";"0";"45080";"46000";"-920"
"2271";"1641909";"2018-03-09";"87779";"2018-03-09";"H-852-17   OTROSI NRO 001";"46000";"45080";"920";"0";"0";"0";"0";"0";"0";"0";"45080";"46000";"-920"
"2272";"1641956";"2018-03-09";"87779";"2018-03-09";"H-852-17   OTROSI NRO 001";"46000";"45080";"920";"0";"0";"0";"0";"0";"0";"0";"45080";"46000";"-920"
"2273";"1642110";"2018-03-09";"87779";"2018-03-09";"H-852-17   OTROSI NRO 001";"46000";"45080";"920";"0";"0";"0";"0";"0";"0";"0";"45080";"46000";"-920"
"2274";"1642115";"2018-03-09";"87779";"2018-03-09";"H-852-17   OTROSI NRO 001";"56000";"54880";"1120";"0";"0";"0";"0";"0";"0";"0";"54880";"56000";"-1120"
"2275";"1642134";"2018-03-09";"87779";"2018-03-09";"H-852-17   OTROSI NRO 001";"46000";"45080";"920";"0";"0";"0";"0";"0";"0";"0";"45080";"46000";"-920"
"2276";"1642137";"2018-03-09";"87779";"2018-03-09";"H-852-17   OTROSI NRO 001";"46000";"45080";"920";"0";"0";"0";"0";"0";"0";"0";"45080";"46000";"-920"
"2277";"1642153";"2018-03-09";"87779";"2018-03-09";"H-852-17   OTROSI NRO 001";"46000";"45080";"920";"0";"0";"0";"0";"0";"0";"0";"45080";"46000";"-920"
"2278";"1642174";"2018-03-09";"87779";"2018-03-09";"H-852-17   OTROSI NRO 001";"46000";"45080";"920";"0";"0";"0";"0";"0";"0";"0";"45080";"46000";"-920"
"2279";"1642179";"2018-03-09";"87779";"2018-03-09";"H-852-17   OTROSI NRO 001";"56000";"54880";"1120";"0";"0";"0";"0";"0";"0";"0";"54880";"56000";"-1120"
"2280";"1642180";"2018-03-09";"87779";"2018-03-09";"H-852-17   OTROSI NRO 001";"46000";"45080";"920";"0";"0";"0";"0";"0";"0";"0";"45080";"46000";"-920"
"2281";"1642183";"2018-03-09";"87779";"2018-03-09";"H-852-17   OTROSI NRO 001";"46000";"45080";"920";"0";"0";"0";"0";"0";"0";"0";"45080";"46000";"-920"
"2282";"1642190";"2018-03-09";"87779";"2018-03-09";"H-852-17   OTROSI NRO 001";"46000";"45080";"920";"0";"0";"0";"0";"0";"0";"0";"45080";"46000";"-920"
"2283";"1642343";"2018-03-09";"87779";"2018-03-09";"H-852-17   OTROSI NRO 001";"35000";"34300";"700";"0";"0";"0";"0";"0";"0";"0";"34300";"35000";"-700"
"2284";"1628535";"2018-03-12";"87571";"2018-03-12";"H-852-17   OTROSI NRO 001";"311000";"304780";"6220";"0";"0";"0";"0";"0";"0";"0";"304780";"311000";"-6220"
"2285";"1631301";"2018-03-12";"87571";"2018-03-12";"H-852-17   OTROSI NRO 001";"311000";"304780";"6220";"0";"0";"0";"0";"0";"0";"0";"304780";"311000";"-6220"
"2286";"1634374";"2018-03-12";"87571";"2018-03-12";"H-852-17   OTROSI NRO 001";"56000";"54880";"1120";"0";"0";"0";"0";"0";"0";"0";"54880";"56000";"-1120"
"2287";"1634417";"2018-03-12";"87571";"2018-03-12";"H-852-17   OTROSI NRO 001";"46000";"45080";"920";"0";"0";"0";"0";"0";"0";"0";"45080";"46000";"-920"
"2288";"1634454";"2018-03-12";"87571";"2018-03-12";"H-852-17   OTROSI NRO 001";"46000";"45080";"920";"0";"0";"0";"0";"0";"0";"0";"45080";"46000";"-920"
"2289";"1634480";"2018-03-12";"87571";"2018-03-12";"H-852-17   OTROSI NRO 001";"70000";"68600";"1400";"0";"0";"0";"0";"0";"0";"0";"68600";"70000";"-1400"
"2290";"1634529";"2018-03-12";"87571";"2018-03-12";"H-852-17   OTROSI NRO 001";"70000";"68600";"1400";"0";"0";"0";"0";"0";"0";"0";"68600";"70000";"-1400"
"2291";"1635206";"2018-03-12";"87571";"2018-03-12";"H-852-17   OTROSI NRO 001";"46000";"45080";"920";"0";"0";"0";"0";"0";"0";"0";"45080";"46000";"-920"
"2292";"1635264";"2018-03-12";"87571";"2018-03-12";"H-852-17   OTROSI NRO 001";"46000";"45080";"920";"0";"0";"0";"0";"0";"0";"0";"45080";"46000";"-920"
"2293";"1635320";"2018-03-12";"87571";"2018-03-12";"H-852-17   OTROSI NRO 001";"46000";"45080";"920";"0";"0";"0";"0";"0";"0";"0";"45080";"46000";"-920"
"2294";"1635321";"2018-03-12";"87571";"2018-03-12";"H-852-17   OTROSI NRO 001";"46000";"45080";"920";"0";"0";"0";"0";"0";"0";"0";"45080";"46000";"-920"
"2295";"1635332";"2018-03-12";"87571";"2018-03-12";"H-852-17   OTROSI NRO 001";"46000";"45080";"920";"0";"0";"0";"0";"0";"0";"0";"45080";"46000";"-920"
"2296";"1635457";"2018-03-12";"87571";"2018-03-12";"H-852-17   OTROSI NRO 001";"46000";"45080";"920";"0";"0";"0";"0";"0";"0";"0";"45080";"46000";"-920"
"2297";"1635481";"2018-03-12";"87571";"2018-03-12";"H-852-17   OTROSI NRO 001";"70000";"68600";"1400";"0";"0";"0";"0";"0";"0";"0";"68600";"70000";"-1400"
"2298";"1635487";"2018-03-12";"87571";"2018-03-12";"H-852-17   OTROSI NRO 001";"46000";"45080";"920";"0";"0";"0";"0";"0";"0";"0";"45080";"46000";"-920"
"2299";"1635488";"2018-03-12";"87571";"2018-03-12";"H-852-17   OTROSI NRO 001";"70000";"68600";"1400";"0";"0";"0";"0";"0";"0";"0";"68600";"70000";"-1400"
"2300";"1635522";"2018-03-12";"87571";"2018-03-12";"H-852-17   OTROSI NRO 001";"70000";"68600";"1400";"0";"0";"0";"0";"0";"0";"0";"68600";"70000";"-1400"
"2301";"1635527";"2018-03-12";"87571";"2018-03-12";"H-852-17   OTROSI NRO 001";"46000";"45080";"920";"0";"0";"0";"0";"0";"0";"0";"45080";"46000";"-920"
"2302";"1635567";"2018-03-12";"87571";"2018-03-12";"H-852-17   OTROSI NRO 001";"46000";"45080";"920";"0";"0";"0";"0";"0";"0";"0";"45080";"46000";"-920"
"2303";"1636079";"2018-03-12";"87571";"2018-03-12";"H-852-17   OTROSI NRO 001";"46000";"45080";"920";"0";"0";"0";"0";"0";"0";"0";"45080";"46000";"-920"
"2304";"1636737";"2018-03-12";"87571";"2018-03-12";"H-852-17   OTROSI NRO 001";"46000";"45080";"920";"0";"0";"0";"0";"0";"0";"0";"45080";"46000";"-920"
"2305";"1636745";"2018-03-12";"87571";"2018-03-12";"H-852-17   OTROSI NRO 001";"70000";"68600";"1400";"0";"0";"0";"0";"0";"0";"0";"68600";"70000";"-1400"
"2306";"1636916";"2018-03-12";"87571";"2018-03-12";"H-852-17   OTROSI NRO 001";"46000";"45080";"920";"0";"0";"0";"0";"0";"0";"0";"45080";"46000";"-920"
"2307";"1638296";"2018-03-12";"87571";"2018-03-12";"H-852-17   OTROSI NRO 001";"70000";"68600";"1400";"0";"0";"0";"0";"0";"0";"0";"68600";"70000";"-1400"
"2308";"1638315";"2018-03-12";"87571";"2018-03-12";"H-852-17   OTROSI NRO 001";"70000";"68600";"1400";"0";"0";"0";"0";"0";"0";"0";"68600";"70000";"-1400"
"2309";"1638381";"2018-03-12";"87571";"2018-03-12";"H-852-17   OTROSI NRO 001";"46000";"45080";"920";"0";"0";"0";"0";"0";"0";"0";"45080";"46000";"-920"
"2310";"1638635";"2018-03-12";"87571";"2018-03-12";"H-852-17   OTROSI NRO 001";"46000";"45080";"920";"0";"0";"0";"0";"0";"0";"0";"45080";"46000";"-920"
"2311";"1638647";"2018-03-12";"87571";"2018-03-12";"H-852-17   OTROSI NRO 001";"35000";"34300";"700";"0";"0";"0";"0";"0";"0";"0";"34300";"35000";"-700"
"2312";"1638736";"2018-03-12";"87571";"2018-03-12";"H-852-17   OTROSI NRO 001";"35000";"34300";"700";"0";"0";"0";"0";"0";"0";"0";"34300";"35000";"-700"
"2313";"1638740";"2018-03-12";"87571";"2018-03-12";"H-852-17   OTROSI NRO 001";"56000";"54880";"1120";"0";"0";"0";"0";"0";"0";"0";"54880";"56000";"-1120"
"2314";"1638825";"2018-03-12";"87571";"2018-03-12";"H-852-17   OTROSI NRO 001";"70000";"68600";"1400";"0";"0";"0";"0";"0";"0";"0";"68600";"70000";"-1400"
"2315";"1638954";"2018-03-12";"87571";"2018-03-12";"H-852-17   OTROSI NRO 001";"70000";"68600";"1400";"0";"0";"0";"0";"0";"0";"0";"68600";"70000";"-1400"
"2316";"1638964";"2018-03-12";"87571";"2018-03-12";"H-852-17   OTROSI NRO 001";"35000";"34300";"700";"0";"0";"0";"0";"0";"0";"0";"34300";"35000";"-700"
"2317";"1638973";"2018-03-12";"87571";"2018-03-12";"H-852-17   OTROSI NRO 001";"46000";"45080";"920";"0";"0";"0";"0";"0";"0";"0";"45080";"46000";"-920"
"2318";"1627692";"2018-03-12";"87577";"2018-03-12";"H-852-17   OTROSI NRO 001";"719940";"705541";"14399";"0";"0";"0";"0";"0";"0";"0";"705541";"719940";"-14399"
"2319";"1628716";"2018-03-12";"87577";"2018-03-12";"H-852-17   OTROSI NRO 001";"159259";"156074";"3185";"0";"0";"0";"0";"0";"0";"0";"156074";"159259";"-3185"
"2320";"1629642";"2018-03-12";"87577";"2018-03-12";"H-852-17   OTROSI NRO 001";"274200";"268716";"5484";"0";"0";"0";"0";"0";"0";"0";"268716";"274200";"-5484"
"2321";"1629747";"2018-03-12";"87577";"2018-03-12";"H-852-17   OTROSI NRO 001";"274200";"268716";"5484";"0";"0";"0";"0";"0";"0";"0";"268716";"274200";"-5484"
"2322";"1630193";"2018-03-12";"87577";"2018-03-12";"H-852-17   OTROSI NRO 001";"548400";"537432";"10968";"0";"0";"0";"0";"0";"0";"0";"537432";"548400";"-10968"
"2323";"1630199";"2018-03-12";"87577";"2018-03-12";"H-852-17   OTROSI NRO 001";"548400";"537432";"10968";"0";"0";"0";"0";"0";"0";"0";"537432";"548400";"-10968"
"2324";"1630457";"2018-03-12";"87577";"2018-03-12";"H-852-17   OTROSI NRO 001";"230108";"225506";"4602";"0";"0";"0";"0";"0";"0";"0";"225506";"230108";"-4602"
"2325";"1631293";"2018-03-12";"87577";"2018-03-12";"H-852-17   OTROSI NRO 001";"274200";"268716";"5484";"0";"0";"0";"0";"0";"0";"0";"268716";"274200";"-5484"
"2326";"1631573";"2018-03-12";"87577";"2018-03-12";"H-852-17   OTROSI NRO 001";"274200";"268716";"5484";"0";"0";"0";"0";"0";"0";"0";"268716";"274200";"-5484"
"2327";"1631637";"2018-03-12";"87577";"2018-03-12";"H-852-17   OTROSI NRO 001";"274200";"268716";"5484";"0";"0";"0";"0";"0";"0";"0";"268716";"274200";"-5484"
"2328";"1631785";"2018-03-12";"87577";"2018-03-12";"H-852-17   OTROSI NRO 001";"548400";"537432";"10968";"0";"0";"0";"0";"0";"0";"0";"537432";"548400";"-10968"
"2329";"1632273";"2018-03-12";"87577";"2018-03-12";"H-852-17   OTROSI NRO 001";"43300";"42434";"866";"0";"0";"0";"0";"0";"0";"0";"42434";"43300";"-866"
"2330";"1632282";"2018-03-12";"87577";"2018-03-12";"H-852-17   OTROSI NRO 001";"548400";"537432";"10968";"0";"0";"0";"0";"0";"0";"0";"537432";"548400";"-10968"
"2331";"1632298";"2018-03-12";"87577";"2018-03-12";"H-852-17   OTROSI NRO 001";"147500";"144550";"2950";"0";"0";"0";"0";"0";"0";"0";"144550";"147500";"-2950"
"2332";"1632739";"2018-03-12";"87577";"2018-03-12";"H-852-17   OTROSI NRO 001";"46000";"45080";"920";"0";"0";"0";"0";"0";"0";"0";"45080";"46000";"-920"
"2333";"1633098";"2018-03-12";"87577";"2018-03-12";"H-852-17   OTROSI NRO 001";"46000";"45080";"920";"0";"0";"0";"0";"0";"0";"0";"45080";"46000";"-920"
"2334";"1633250";"2018-03-12";"87577";"2018-03-12";"H-852-17   OTROSI NRO 001";"46000";"45080";"920";"0";"0";"0";"0";"0";"0";"0";"45080";"46000";"-920"
"2335";"1633301";"2018-03-12";"87577";"2018-03-12";"H-852-17   OTROSI NRO 001";"46000";"45080";"920";"0";"0";"0";"0";"0";"0";"0";"45080";"46000";"-920"
"2336";"1633320";"2018-03-12";"87577";"2018-03-12";"H-852-17   OTROSI NRO 001";"46000";"45080";"920";"0";"0";"0";"0";"0";"0";"0";"45080";"46000";"-920"
"2337";"1633346";"2018-03-12";"87577";"2018-03-12";"H-852-17   OTROSI NRO 001";"46000";"45080";"920";"0";"0";"0";"0";"0";"0";"0";"45080";"46000";"-920"
"2338";"1633359";"2018-03-12";"87577";"2018-03-12";"H-852-17   OTROSI NRO 001";"46000";"45080";"920";"0";"0";"0";"0";"0";"0";"0";"45080";"46000";"-920"
"2339";"1633462";"2018-03-12";"87577";"2018-03-12";"H-852-17   OTROSI NRO 001";"56000";"54880";"1120";"0";"0";"0";"0";"0";"0";"0";"54880";"56000";"-1120"
"2340";"1633481";"2018-03-12";"87577";"2018-03-12";"H-852-17   OTROSI NRO 001";"46000";"45080";"920";"0";"0";"0";"0";"0";"0";"0";"45080";"46000";"-920"
"2341";"1634061";"2018-03-12";"87577";"2018-03-12";"H-852-17   OTROSI NRO 001";"46000";"45080";"920";"0";"0";"0";"0";"0";"0";"0";"45080";"46000";"-920"
"2342";"1636765";"2018-03-12";"87577";"2018-03-12";"H-852-17   OTROSI NRO 001";"46000";"45080";"920";"0";"0";"0";"0";"0";"0";"0";"45080";"46000";"-920"
"2343";"1636771";"2018-03-12";"87577";"2018-03-12";"H-852-17   OTROSI NRO 001";"56000";"54880";"1120";"0";"0";"0";"0";"0";"0";"0";"54880";"56000";"-1120"
"2344";"1636813";"2018-03-12";"87577";"2018-03-12";"H-852-17   OTROSI NRO 001";"35000";"34300";"700";"0";"0";"0";"0";"0";"0";"0";"34300";"35000";"-700"
"2345";"1636848";"2018-03-12";"87577";"2018-03-12";"H-852-17   OTROSI NRO 001";"56000";"54880";"1120";"0";"0";"0";"0";"0";"0";"0";"54880";"56000";"-1120"
"2346";"1636853";"2018-03-12";"87577";"2018-03-12";"H-852-17   OTROSI NRO 001";"46000";"45080";"920";"0";"0";"0";"0";"0";"0";"0";"45080";"46000";"-920"
"2347";"1636865";"2018-03-12";"87577";"2018-03-12";"H-852-17   OTROSI NRO 001";"46000";"45080";"920";"0";"0";"0";"0";"0";"0";"0";"45080";"46000";"-920"
"2348";"1636870";"2018-03-12";"87577";"2018-03-12";"H-852-17   OTROSI NRO 001";"35000";"34300";"700";"0";"0";"0";"0";"0";"0";"0";"34300";"35000";"-700"
"2349";"1636897";"2018-03-12";"87577";"2018-03-12";"H-852-17   OTROSI NRO 001";"56000";"54880";"1120";"0";"0";"0";"0";"0";"0";"0";"54880";"56000";"-1120"
"2350";"1637011";"2018-03-12";"87577";"2018-03-12";"H-852-17   OTROSI NRO 001";"46000";"45080";"920";"0";"0";"0";"0";"0";"0";"0";"45080";"46000";"-920"
"2351";"1641528";"2018-03-12";"87850";"2018-03-12";"H-852-17   OTROSI NRO 001";"46000";"45080";"920";"0";"0";"0";"0";"0";"0";"0";"45080";"46000";"-920"
"2352";"1642092";"2018-03-12";"87850";"2018-03-12";"H-852-17   OTROSI NRO 001";"274200";"268716";"5484";"0";"0";"0";"0";"0";"0";"0";"268716";"274200";"-5484"
"2353";"1642096";"2018-03-12";"87850";"2018-03-12";"H-852-17   OTROSI NRO 001";"274200";"268716";"5484";"0";"0";"0";"0";"0";"0";"0";"268716";"274200";"-5484"
"2354";"1642163";"2018-03-12";"87850";"2018-03-12";"H-852-17   OTROSI NRO 001";"274200";"268716";"5484";"0";"0";"0";"0";"0";"0";"0";"268716";"274200";"-5484"
"2355";"1642539";"2018-03-12";"87850";"2018-03-12";"H-852-17   OTROSI NRO 001";"56000";"54880";"1120";"0";"0";"0";"0";"0";"0";"0";"54880";"56000";"-1120"
"2356";"1642541";"2018-03-12";"87850";"2018-03-12";"H-852-17   OTROSI NRO 001";"70000";"68600";"1400";"0";"0";"0";"0";"0";"0";"0";"68600";"70000";"-1400"
"2357";"1642777";"2018-03-12";"87850";"2018-03-12";"H-852-17   OTROSI NRO 001";"46000";"45080";"920";"0";"0";"0";"0";"0";"0";"0";"45080";"46000";"-920"
"2358";"1642785";"2018-03-12";"87850";"2018-03-12";"H-852-17   OTROSI NRO 001";"70000";"68600";"1400";"0";"0";"0";"0";"0";"0";"0";"68600";"70000";"-1400"
"2359";"1643027";"2018-03-12";"87850";"2018-03-12";"H-852-17   OTROSI NRO 001";"70000";"68600";"1400";"0";"0";"0";"0";"0";"0";"0";"68600";"70000";"-1400"
"2360";"1643086";"2018-03-12";"87850";"2018-03-12";"H-852-17   OTROSI NRO 001";"70000";"68600";"1400";"0";"0";"0";"0";"0";"0";"0";"68600";"70000";"-1400"
"2361";"1643106";"2018-03-12";"87850";"2018-03-12";"H-852-17   OTROSI NRO 001";"70000";"68600";"1400";"0";"0";"0";"0";"0";"0";"0";"68600";"70000";"-1400"
"2362";"1643256";"2018-03-12";"87850";"2018-03-12";"H-852-17   OTROSI NRO 001";"46000";"45080";"920";"0";"0";"0";"0";"0";"0";"0";"45080";"46000";"-920"
"2363";"1643427";"2018-03-12";"87850";"2018-03-12";"H-852-17   OTROSI NRO 001";"56000";"54880";"1120";"0";"0";"0";"0";"0";"0";"0";"54880";"56000";"-1120"
"2364";"1643428";"2018-03-12";"87850";"2018-03-12";"H-852-17   OTROSI NRO 001";"56000";"54880";"1120";"0";"0";"0";"0";"0";"0";"0";"54880";"56000";"-1120"
"2365";"1643429";"2018-03-12";"87850";"2018-03-12";"H-852-17   OTROSI NRO 001";"56000";"54880";"1120";"0";"0";"0";"0";"0";"0";"0";"54880";"56000";"-1120"
"2366";"1643430";"2018-03-12";"87850";"2018-03-12";"H-852-17   OTROSI NRO 001";"56000";"54880";"1120";"0";"0";"0";"0";"0";"0";"0";"54880";"56000";"-1120"
"2367";"1643529";"2018-03-12";"87850";"2018-03-12";"H-852-17   OTROSI NRO 001";"56000";"54880";"1120";"0";"0";"0";"0";"0";"0";"0";"54880";"56000";"-1120"
"2368";"1643746";"2018-03-12";"87850";"2018-03-12";"H-852-17   OTROSI NRO 001";"70000";"68600";"1400";"0";"0";"0";"0";"0";"0";"0";"68600";"70000";"-1400"
"2369";"1643751";"2018-03-12";"87850";"2018-03-12";"H-852-17   OTROSI NRO 001";"46000";"45080";"920";"0";"0";"0";"0";"0";"0";"0";"45080";"46000";"-920"
"2370";"1643769";"2018-03-12";"87850";"2018-03-12";"H-852-17   OTROSI NRO 001";"46000";"45080";"920";"0";"0";"0";"0";"0";"0";"0";"45080";"46000";"-920"
"2371";"1643805";"2018-03-12";"87850";"2018-03-12";"H-852-17   OTROSI NRO 001";"46000";"45080";"920";"0";"0";"0";"0";"0";"0";"0";"45080";"46000";"-920"
"2372";"1644105";"2018-03-12";"87850";"2018-03-12";"H-852-17   OTROSI NRO 001";"56000";"54880";"1120";"0";"0";"0";"0";"0";"0";"0";"54880";"56000";"-1120"
"2373";"1644634";"2018-03-12";"87850";"2018-03-12";"H-852-17   OTROSI NRO 001";"46000";"45080";"920";"0";"0";"0";"0";"0";"0";"0";"45080";"46000";"-920"
"2374";"1644962";"2018-03-12";"87850";"2018-03-12";"H-852-17   OTROSI NRO 001";"70000";"68600";"1400";"0";"0";"0";"0";"0";"0";"0";"68600";"70000";"-1400"
"2375";"1645012";"2018-03-12";"87850";"2018-03-12";"H-852-17   OTROSI NRO 001";"70000";"68600";"1400";"0";"0";"0";"0";"0";"0";"0";"68600";"70000";"-1400"
"2376";"1645014";"2018-03-12";"87850";"2018-03-12";"H-852-17   OTROSI NRO 001";"56000";"54880";"1120";"0";"0";"0";"0";"0";"0";"0";"54880";"56000";"-1120"
"2377";"1645033";"2018-03-12";"87850";"2018-03-12";"H-852-17   OTROSI NRO 001";"35000";"34300";"700";"0";"0";"0";"0";"0";"0";"0";"34300";"35000";"-700"
"2378";"1645060";"2018-03-12";"87850";"2018-03-12";"H-852-17   OTROSI NRO 001";"56000";"54880";"1120";"0";"0";"0";"0";"0";"0";"0";"54880";"56000";"-1120"
"2379";"1645082";"2018-03-12";"87850";"2018-03-12";"H-852-17   OTROSI NRO 001";"46000";"45080";"920";"0";"0";"0";"0";"0";"0";"0";"45080";"46000";"-920"
"2380";"1645099";"2018-03-12";"87850";"2018-03-12";"H-852-17   OTROSI NRO 001";"70000";"68600";"1400";"0";"0";"0";"0";"0";"0";"0";"68600";"70000";"-1400"
"2381";"1645222";"2018-03-12";"87850";"2018-03-12";"H-852-17   OTROSI NRO 001";"35000";"34300";"700";"0";"0";"0";"0";"0";"0";"0";"34300";"35000";"-700"
"2382";"1645250";"2018-03-12";"87850";"2018-03-12";"H-852-17   OTROSI NRO 001";"35000";"34300";"700";"0";"0";"0";"0";"0";"0";"0";"34300";"35000";"-700"
"2383";"1619862";"2018-03-12";"87780";"2018-03-12";"H-852-17   OTROSI NRO 001";"274200";"268716";"5484";"0";"0";"0";"0";"0";"0";"0";"268716";"274200";"-5484"
"2384";"1620638";"2018-03-12";"87780";"2018-03-12";"H-852-17   OTROSI NRO 001";"274200";"268716";"5484";"0";"0";"0";"0";"0";"0";"0";"268716";"274200";"-5484"
"2385";"1620649";"2018-03-12";"87780";"2018-03-12";"H-852-17   OTROSI NRO 001";"274200";"268716";"5484";"0";"0";"0";"0";"0";"0";"0";"268716";"274200";"-5484"
"2386";"1638049";"2018-03-12";"87780";"2018-03-12";"H-852-17   OTROSI NRO 001";"70000";"68600";"1400";"0";"0";"0";"0";"0";"0";"0";"68600";"70000";"-1400"
"2387";"1639274";"2018-03-12";"87780";"2018-03-12";"H-852-17   OTROSI NRO 001";"46000";"45080";"920";"0";"0";"0";"0";"0";"0";"0";"45080";"46000";"-920"
"2388";"1639878";"2018-03-12";"87780";"2018-03-12";"H-852-17   OTROSI NRO 001";"46000";"45080";"920";"0";"0";"0";"0";"0";"0";"0";"45080";"46000";"-920"
"2389";"1639911";"2018-03-12";"87780";"2018-03-12";"H-852-17   OTROSI NRO 001";"46000";"45080";"920";"0";"0";"0";"0";"0";"0";"0";"45080";"46000";"-920"
"2390";"1639998";"2018-03-12";"87780";"2018-03-12";"H-852-17   OTROSI NRO 001";"46000";"45080";"920";"0";"0";"0";"0";"0";"0";"0";"45080";"46000";"-920"
"2391";"1640008";"2018-03-12";"87780";"2018-03-12";"H-852-17   OTROSI NRO 001";"46000";"45080";"920";"0";"0";"0";"0";"0";"0";"0";"45080";"46000";"-920"
"2392";"1640115";"2018-03-12";"87780";"2018-03-12";"H-852-17   OTROSI NRO 001";"72800";"71344";"1456";"0";"0";"0";"0";"0";"0";"0";"71344";"72800";"-1456"
"2393";"1641476";"2018-03-12";"87780";"2018-03-12";"H-852-17   OTROSI NRO 001";"56000";"54880";"1120";"0";"0";"0";"0";"0";"0";"0";"54880";"56000";"-1120"
"2394";"1641978";"2018-03-12";"87780";"2018-03-12";"H-852-17   OTROSI NRO 001";"56000";"54880";"1120";"0";"0";"0";"0";"0";"0";"0";"54880";"56000";"-1120"
"2395";"1641980";"2018-03-12";"87780";"2018-03-12";"H-852-17   OTROSI NRO 001";"46000";"45080";"920";"0";"0";"0";"0";"0";"0";"0";"45080";"46000";"-920"
"2396";"1641989";"2018-03-12";"87780";"2018-03-12";"H-852-17   OTROSI NRO 001";"35000";"34300";"700";"0";"0";"0";"0";"0";"0";"0";"34300";"35000";"-700"
"2397";"1642003";"2018-03-12";"87780";"2018-03-12";"H-852-17   OTROSI NRO 001";"46000";"45080";"920";"0";"0";"0";"0";"0";"0";"0";"45080";"46000";"-920"
"2398";"1642064";"2018-03-12";"87780";"2018-03-12";"H-852-17   OTROSI NRO 001";"56000";"54880";"1120";"0";"0";"0";"0";"0";"0";"0";"54880";"56000";"-1120"
"2399";"1642902";"2018-03-12";"87780";"2018-03-12";"H-852-17   OTROSI NRO 001";"46000";"45080";"920";"0";"0";"0";"0";"0";"0";"0";"45080";"46000";"-920"
"2400";"1644335";"2018-03-12";"87780";"2018-03-12";"H-852-17   OTROSI NRO 001";"35000";"34300";"700";"0";"0";"0";"0";"0";"0";"0";"34300";"35000";"-700"
"2401";"1644495";"2018-03-12";"87780";"2018-03-12";"H-852-17   OTROSI NRO 001";"56000";"54880";"1120";"0";"0";"0";"0";"0";"0";"0";"54880";"56000";"-1120"
"2402";"1629182";"2018-03-12";"87579";"2018-03-12";"H-852-17   OTROSI NRO 001";"252990";"247930";"5060";"0";"0";"0";"0";"0";"0";"0";"247930";"252990";"-5060"
"2403";"1632893";"2018-03-12";"87579";"2018-03-12";"H-852-17   OTROSI NRO 001";"46000";"45080";"920";"0";"0";"0";"0";"0";"0";"0";"45080";"46000";"-920"
"2404";"1633290";"2018-03-12";"87579";"2018-03-12";"H-852-17   OTROSI NRO 001";"56000";"54880";"1120";"0";"0";"0";"0";"0";"0";"0";"54880";"56000";"-1120"
"2405";"1633305";"2018-03-12";"87579";"2018-03-12";"H-852-17   OTROSI NRO 001";"46000";"45080";"920";"0";"0";"0";"0";"0";"0";"0";"45080";"46000";"-920"
"2406";"1633306";"2018-03-12";"87579";"2018-03-12";"H-852-17   OTROSI NRO 001";"46000";"45080";"920";"0";"0";"0";"0";"0";"0";"0";"45080";"46000";"-920"
"2407";"1633365";"2018-03-12";"87579";"2018-03-12";"H-852-17   OTROSI NRO 001";"46000";"45080";"920";"0";"0";"0";"0";"0";"0";"0";"45080";"46000";"-920"
"2408";"1633429";"2018-03-12";"87579";"2018-03-12";"H-852-17   OTROSI NRO 001";"46000";"45080";"920";"0";"0";"0";"0";"0";"0";"0";"45080";"46000";"-920"
"2409";"1633485";"2018-03-12";"87579";"2018-03-12";"H-852-17   OTROSI NRO 001";"46000";"45080";"920";"0";"0";"0";"0";"0";"0";"0";"45080";"46000";"-920"
"2410";"1633507";"2018-03-12";"87579";"2018-03-12";"H-852-17   OTROSI NRO 001";"46000";"45080";"920";"0";"0";"0";"0";"0";"0";"0";"45080";"46000";"-920"
"2411";"1633676";"2018-03-12";"87579";"2018-03-12";"H-852-17   OTROSI NRO 001";"46000";"45080";"920";"0";"0";"0";"0";"0";"0";"0";"45080";"46000";"-920"
"2412";"1633721";"2018-03-12";"87579";"2018-03-12";"H-852-17   OTROSI NRO 001";"46000";"45080";"920";"0";"0";"0";"0";"0";"0";"0";"45080";"46000";"-920"
"2413";"1633820";"2018-03-12";"87579";"2018-03-12";"H-852-17   OTROSI NRO 001";"46000";"45080";"920";"0";"0";"0";"0";"0";"0";"0";"45080";"46000";"-920"
"2414";"1633878";"2018-03-12";"87579";"2018-03-12";"H-852-17   OTROSI NRO 001";"46000";"45080";"920";"0";"0";"0";"0";"0";"0";"0";"45080";"46000";"-920"
"2415";"1633956";"2018-03-12";"87579";"2018-03-12";"H-852-17   OTROSI NRO 001";"35000";"34300";"700";"0";"0";"0";"0";"0";"0";"0";"34300";"35000";"-700"
"2416";"1633959";"2018-03-12";"87579";"2018-03-12";"H-852-17   OTROSI NRO 001";"46000";"45080";"920";"0";"0";"0";"0";"0";"0";"0";"45080";"46000";"-920"
"2417";"1634002";"2018-03-12";"87579";"2018-03-12";"H-852-17   OTROSI NRO 001";"46000";"45080";"920";"0";"0";"0";"0";"0";"0";"0";"45080";"46000";"-920"
"2418";"1634007";"2018-03-12";"87579";"2018-03-12";"H-852-17   OTROSI NRO 001";"46000";"45080";"920";"0";"0";"0";"0";"0";"0";"0";"45080";"46000";"-920"
"2419";"1634028";"2018-03-12";"87579";"2018-03-12";"H-852-17   OTROSI NRO 001";"35000";"34300";"700";"0";"0";"0";"0";"0";"0";"0";"34300";"35000";"-700"
"2420";"1634048";"2018-03-12";"87579";"2018-03-12";"H-852-17   OTROSI NRO 001";"46000";"45080";"920";"0";"0";"0";"0";"0";"0";"0";"45080";"46000";"-920"
"2421";"1634054";"2018-03-12";"87579";"2018-03-12";"H-852-17   OTROSI NRO 001";"46000";"45080";"920";"0";"0";"0";"0";"0";"0";"0";"45080";"46000";"-920"
"2422";"1634062";"2018-03-12";"87579";"2018-03-12";"H-852-17   OTROSI NRO 001";"46000";"45080";"920";"0";"0";"0";"0";"0";"0";"0";"45080";"46000";"-920"
"2423";"1634069";"2018-03-12";"87579";"2018-03-12";"H-852-17   OTROSI NRO 001";"46000";"45080";"920";"0";"0";"0";"0";"0";"0";"0";"45080";"46000";"-920"
"2424";"1634115";"2018-03-12";"87579";"2018-03-12";"H-852-17   OTROSI NRO 001";"46000";"45080";"920";"0";"0";"0";"0";"0";"0";"0";"45080";"46000";"-920"
"2425";"1634145";"2018-03-12";"87579";"2018-03-12";"H-852-17   OTROSI NRO 001";"46000";"45080";"920";"0";"0";"0";"0";"0";"0";"0";"45080";"46000";"-920"
"2426";"1634170";"2018-03-12";"87579";"2018-03-12";"H-852-17   OTROSI NRO 001";"46000";"45080";"920";"0";"0";"0";"0";"0";"0";"0";"45080";"46000";"-920"
"2427";"1634244";"2018-03-12";"87579";"2018-03-12";"H-852-17   OTROSI NRO 001";"46000";"45080";"920";"0";"0";"0";"0";"0";"0";"0";"45080";"46000";"-920"
"2428";"1634257";"2018-03-12";"87579";"2018-03-12";"H-852-17   OTROSI NRO 001";"46000";"45080";"920";"0";"0";"0";"0";"0";"0";"0";"45080";"46000";"-920"
"2429";"1634265";"2018-03-12";"87579";"2018-03-12";"H-852-17   OTROSI NRO 001";"46000";"45080";"920";"0";"0";"0";"0";"0";"0";"0";"45080";"46000";"-920"
"2430";"1637050";"2018-03-12";"87579";"2018-03-12";"H-852-17   OTROSI NRO 001";"35000";"34300";"700";"0";"0";"0";"0";"0";"0";"0";"34300";"35000";"-700"
"2431";"1637065";"2018-03-12";"87579";"2018-03-12";"H-852-17   OTROSI NRO 001";"35000";"34300";"700";"0";"0";"0";"0";"0";"0";"0";"34300";"35000";"-700"
"2432";"1637066";"2018-03-12";"87579";"2018-03-12";"H-852-17   OTROSI NRO 001";"46000";"45080";"920";"0";"0";"0";"0";"0";"0";"0";"45080";"46000";"-920"
"2433";"1637080";"2018-03-12";"87579";"2018-03-12";"H-852-17   OTROSI NRO 001";"56000";"54880";"1120";"0";"0";"0";"0";"0";"0";"0";"54880";"56000";"-1120"
"2434";"1637108";"2018-03-12";"87579";"2018-03-12";"H-852-17   OTROSI NRO 001";"46000";"45080";"920";"0";"0";"0";"0";"0";"0";"0";"45080";"46000";"-920"
"2435";"1637200";"2018-03-12";"87579";"2018-03-12";"H-852-17   OTROSI NRO 001";"46000";"45080";"920";"0";"0";"0";"0";"0";"0";"0";"45080";"46000";"-920"
"2436";"1603700";"2018-03-12";"88044";"2018-03-12";"H-852-17   OTROSI NRO 001";"56000";"54880";"1120";"0";"0";"0";"0";"0";"0";"0";"54880";"56000";"-1120"
"2437";"1640757";"2018-03-12";"88044";"2018-03-12";"H-852-17   OTROSI NRO 001";"548400";"537432";"10968";"0";"0";"0";"0";"0";"0";"0";"537432";"548400";"-10968"
"2438";"1641188";"2018-03-12";"88044";"2018-03-12";"H-852-17   OTROSI NRO 001";"274200";"268716";"5484";"0";"0";"0";"0";"0";"0";"0";"268716";"274200";"-5484"
"2439";"1644908";"2018-03-12";"88044";"2018-03-12";"H-852-17   OTROSI NRO 001";"46000";"45080";"920";"0";"0";"0";"0";"0";"0";"0";"45080";"46000";"-920"
"2440";"1645064";"2018-03-12";"88044";"2018-03-12";"H-852-17   OTROSI NRO 001";"56000";"54880";"1120";"0";"0";"0";"0";"0";"0";"0";"54880";"56000";"-1120"
"2441";"1645531";"2018-03-12";"88044";"2018-03-12";"H-852-17   OTROSI NRO 001";"46000";"45080";"920";"0";"0";"0";"0";"0";"0";"0";"45080";"46000";"-920"
"2442";"1645576";"2018-03-12";"88044";"2018-03-12";"H-852-17   OTROSI NRO 001";"46000";"45080";"920";"0";"0";"0";"0";"0";"0";"0";"45080";"46000";"-920"
"2443";"1645684";"2018-03-12";"88044";"2018-03-12";"H-852-17   OTROSI NRO 001";"35000";"34300";"700";"0";"0";"0";"0";"0";"0";"0";"34300";"35000";"-700"
"2444";"1645978";"2018-03-12";"88044";"2018-03-12";"H-852-17   OTROSI NRO 001";"46000";"45080";"920";"0";"0";"0";"0";"0";"0";"0";"45080";"46000";"-920"
"2445";"1646101";"2018-03-12";"88044";"2018-03-12";"H-852-17   OTROSI NRO 001";"35000";"34300";"700";"0";"0";"0";"0";"0";"0";"0";"34300";"35000";"-700"
"2446";"1646103";"2018-03-12";"88044";"2018-03-12";"H-852-17   OTROSI NRO 001";"46000";"45080";"920";"0";"0";"0";"0";"0";"0";"0";"45080";"46000";"-920"
"2447";"1646123";"2018-03-12";"88044";"2018-03-12";"H-852-17   OTROSI NRO 001";"70000";"68600";"1400";"0";"0";"0";"0";"0";"0";"0";"68600";"70000";"-1400"
"2448";"1646151";"2018-03-12";"88044";"2018-03-12";"H-852-17   OTROSI NRO 001";"35000";"34300";"700";"0";"0";"0";"0";"0";"0";"0";"34300";"35000";"-700"
"2449";"1646468";"2018-03-12";"88044";"2018-03-12";"H-852-17   OTROSI NRO 001";"180000";"176400";"3600";"0";"0";"0";"0";"0";"0";"0";"176400";"180000";"-3600"
"2450";"1646479";"2018-03-12";"88044";"2018-03-12";"H-852-17   OTROSI NRO 001";"46000";"45080";"920";"0";"0";"0";"0";"0";"0";"0";"45080";"46000";"-920"
"2451";"1646490";"2018-03-12";"88044";"2018-03-12";"H-852-17   OTROSI NRO 001";"46000";"45080";"920";"0";"0";"0";"0";"0";"0";"0";"45080";"46000";"-920"
"2452";"1646625";"2018-03-12";"88044";"2018-03-12";"H-852-17   OTROSI NRO 001";"46000";"45080";"920";"0";"0";"0";"0";"0";"0";"0";"45080";"46000";"-920"
"2453";"1646643";"2018-03-12";"88044";"2018-03-12";"H-852-17   OTROSI NRO 001";"46000";"45080";"920";"0";"0";"0";"0";"0";"0";"0";"45080";"46000";"-920"
"2454";"1646686";"2018-03-12";"88044";"2018-03-12";"H-852-17   OTROSI NRO 001";"46000";"45080";"920";"0";"0";"0";"0";"0";"0";"0";"45080";"46000";"-920"
"2455";"1646871";"2018-03-12";"88044";"2018-03-12";"H-852-17   OTROSI NRO 001";"70000";"68600";"1400";"0";"0";"0";"0";"0";"0";"0";"68600";"70000";"-1400"
"2456";"1647060";"2018-03-12";"88044";"2018-03-12";"H-852-17   OTROSI NRO 001";"46000";"45080";"920";"0";"0";"0";"0";"0";"0";"0";"45080";"46000";"-920"
"2457";"1647169";"2018-03-12";"88044";"2018-03-12";"H-852-17   OTROSI NRO 001";"46000";"45080";"920";"0";"0";"0";"0";"0";"0";"0";"45080";"46000";"-920"
"2458";"1647234";"2018-03-12";"88044";"2018-03-12";"H-852-17   OTROSI NRO 001";"46000";"45080";"920";"0";"0";"0";"0";"0";"0";"0";"45080";"46000";"-920"
"2459";"1647498";"2018-03-12";"88044";"2018-03-12";"H-852-17   OTROSI NRO 001";"46000";"45080";"920";"0";"0";"0";"0";"0";"0";"0";"45080";"46000";"-920"
"2460";"1647604";"2018-03-12";"88044";"2018-03-12";"H-852-17   OTROSI NRO 001";"46000";"45080";"920";"0";"0";"0";"0";"0";"0";"0";"45080";"46000";"-920"
"2461";"1647662";"2018-03-12";"88044";"2018-03-12";"H-852-17   OTROSI NRO 001";"56000";"54880";"1120";"0";"0";"0";"0";"0";"0";"0";"54880";"56000";"-1120"
"2462";"1647749";"2018-03-12";"88044";"2018-03-12";"H-852-17   OTROSI NRO 001";"46000";"45080";"920";"0";"0";"0";"0";"0";"0";"0";"45080";"46000";"-920"
"2463";"1647789";"2018-03-12";"88044";"2018-03-12";"H-852-17   OTROSI NRO 001";"35000";"34300";"700";"0";"0";"0";"0";"0";"0";"0";"34300";"35000";"-700"
"2464";"1647844";"2018-03-12";"88044";"2018-03-12";"H-852-17   OTROSI NRO 001";"38364";"37597";"767";"0";"0";"0";"0";"0";"0";"0";"37597";"38364";"-767"
"2465";"1647872";"2018-03-12";"88044";"2018-03-12";"H-852-17   OTROSI NRO 001";"46000";"45080";"920";"0";"0";"0";"0";"0";"0";"0";"45080";"46000";"-920"
"2466";"1647922";"2018-03-12";"88044";"2018-03-12";"H-852-17   OTROSI NRO 001";"46000";"45080";"920";"0";"0";"0";"0";"0";"0";"0";"45080";"46000";"-920"
"2467";"1647952";"2018-03-12";"88044";"2018-03-12";"H-852-17   OTROSI NRO 001";"46000";"45080";"920";"0";"0";"0";"0";"0";"0";"0";"45080";"46000";"-920"
"2468";"1632600";"2018-03-12";"87851";"2018-03-12";"H-852-17   OTROSI NRO 001";"1488280";"1458514";"29766";"0";"0";"0";"531378";"421378";"110000";"0";"1037136";"110000";"927136"
"2469";"1644858";"2018-03-12";"88480";"2018-03-12";"H-852-17   OTROSI NRO 001";"1382109";"1354467";"27642";"0";"0";"0";"29780";"680";"29100";"0";"1353787";"1352329";"1458"
"2470";"1646053";"2018-03-12";"88480";"2018-03-12";"H-852-17   OTROSI NRO 001";"4267602";"4182250";"85352";"0";"0";"0";"509700";"0";"509700";"0";"4182250";"4267602";"-85352"
"2471";"1649224";"2018-03-12";"88480";"2018-03-12";"H-852-17   OTROSI NRO 001";"3659531";"3586340";"73191";"0";"0";"0";"1276880";"564980";"711900";"0";"3021360";"2382651";"638709"
"2472";"1631022";"2018-03-12";"87588";"2018-03-12";"H-852-17   OTROSI NRO 001";"29935";"29336";"599";"0";"0";"0";"0";"0";"0";"0";"29336";"29935";"-599"
"2473";"1633618";"2018-03-12";"87588";"2018-03-12";"H-852-17   OTROSI NRO 001";"34315";"33629";"686";"0";"0";"0";"0";"0";"0";"0";"33629";"34315";"-686"
"2474";"1634897";"2018-03-12";"87588";"2018-03-12";"H-852-17   OTROSI NRO 001";"571468";"560039";"11429";"0";"0";"0";"0";"0";"0";"0";"560039";"571468";"-11429"
"2475";"1637788";"2018-03-12";"87588";"2018-03-12";"H-852-17   OTROSI NRO 001";"29935";"29336";"599";"0";"0";"0";"0";"0";"0";"0";"29336";"29935";"-599"
"2476";"1637908";"2018-03-12";"87588";"2018-03-12";"H-852-17   OTROSI NRO 001";"153500";"150430";"3070";"0";"0";"0";"0";"0";"0";"0";"150430";"153500";"-3070"
"2477";"1638027";"2018-03-12";"87588";"2018-03-12";"H-852-17   OTROSI NRO 001";"54000";"52920";"1080";"0";"0";"0";"0";"0";"0";"0";"52920";"54000";"-1080"
"2478";"1638154";"2018-03-12";"87588";"2018-03-12";"H-852-17   OTROSI NRO 001";"92727";"90872";"1855";"0";"0";"0";"0";"0";"0";"0";"90872";"92727";"-1855"
"2479";"1640304";"2018-03-12";"87588";"2018-03-12";"H-852-17   OTROSI NRO 001";"29000";"28420";"580";"0";"0";"0";"0";"0";"0";"0";"28420";"29000";"-580"
"2480";"1643425";"2018-03-12";"87588";"2018-03-12";"H-852-17   OTROSI NRO 001";"153595";"150523";"3072";"0";"0";"0";"0";"0";"0";"0";"150523";"153595";"-3072"
"2481";"1644117";"2018-03-12";"87588";"2018-03-12";"H-852-17   OTROSI NRO 001";"48765";"47790";"975";"0";"0";"0";"0";"0";"0";"0";"47790";"48765";"-975"
"2482";"1630274";"2018-03-12";"87576";"2018-03-12";"H-852-17   OTROSI NRO 001";"46000";"45080";"920";"0";"0";"0";"0";"0";"0";"0";"45080";"46000";"-920"
"2483";"1631821";"2018-03-12";"87576";"2018-03-12";"H-852-17   OTROSI NRO 001";"55400";"54292";"1108";"0";"0";"0";"0";"0";"0";"0";"54292";"55400";"-1108"
"2484";"1633624";"2018-03-12";"87576";"2018-03-12";"H-852-17   OTROSI NRO 001";"46000";"45080";"920";"0";"0";"0";"0";"0";"0";"0";"45080";"46000";"-920"
"2485";"1633633";"2018-03-12";"87576";"2018-03-12";"H-852-17   OTROSI NRO 001";"180000";"176400";"3600";"0";"0";"0";"0";"0";"0";"0";"176400";"180000";"-3600"
"2486";"1633752";"2018-03-12";"87576";"2018-03-12";"H-852-17   OTROSI NRO 001";"46000";"45080";"920";"0";"0";"0";"0";"0";"0";"0";"45080";"46000";"-920"
"2487";"1633830";"2018-03-12";"87576";"2018-03-12";"H-852-17   OTROSI NRO 001";"46000";"45080";"920";"0";"0";"0";"0";"0";"0";"0";"45080";"46000";"-920"
"2488";"1634149";"2018-03-12";"87576";"2018-03-12";"H-852-17   OTROSI NRO 001";"46000";"45080";"920";"0";"0";"0";"0";"0";"0";"0";"45080";"46000";"-920"
"2489";"1634180";"2018-03-12";"87576";"2018-03-12";"H-852-17   OTROSI NRO 001";"46000";"45080";"920";"0";"0";"0";"0";"0";"0";"0";"45080";"46000";"-920"
"2490";"1635304";"2018-03-12";"87576";"2018-03-12";"H-852-17   OTROSI NRO 001";"46000";"45080";"920";"0";"0";"0";"0";"0";"0";"0";"45080";"46000";"-920"
"2491";"1635313";"2018-03-12";"87576";"2018-03-12";"H-852-17   OTROSI NRO 001";"46000";"45080";"920";"0";"0";"0";"0";"0";"0";"0";"45080";"46000";"-920"
"2492";"1635754";"2018-03-12";"87576";"2018-03-12";"H-852-17   OTROSI NRO 001";"70000";"68600";"1400";"0";"0";"0";"0";"0";"0";"0";"68600";"70000";"-1400"
"2493";"1635757";"2018-03-12";"87576";"2018-03-12";"H-852-17   OTROSI NRO 001";"70000";"68600";"1400";"0";"0";"0";"0";"0";"0";"0";"68600";"70000";"-1400"
"2494";"1635803";"2018-03-12";"87576";"2018-03-12";"H-852-17   OTROSI NRO 001";"46000";"45080";"920";"0";"0";"0";"0";"0";"0";"0";"45080";"46000";"-920"
"2495";"1635805";"2018-03-12";"87576";"2018-03-12";"H-852-17   OTROSI NRO 001";"46000";"45080";"920";"0";"0";"0";"0";"0";"0";"0";"45080";"46000";"-920"
"2496";"1635808";"2018-03-12";"87576";"2018-03-12";"H-852-17   OTROSI NRO 001";"70000";"68600";"1400";"0";"0";"0";"0";"0";"0";"0";"68600";"70000";"-1400"
"2497";"1635809";"2018-03-12";"87576";"2018-03-12";"H-852-17   OTROSI NRO 001";"46000";"45080";"920";"0";"0";"0";"0";"0";"0";"0";"45080";"46000";"-920"
"2498";"1636056";"2018-03-12";"87576";"2018-03-12";"H-852-17   OTROSI NRO 001";"46000";"45080";"920";"0";"0";"0";"0";"0";"0";"0";"45080";"46000";"-920"
"2499";"1636069";"2018-03-12";"87576";"2018-03-12";"H-852-17   OTROSI NRO 001";"46000";"45080";"920";"0";"0";"0";"0";"0";"0";"0";"45080";"46000";"-920"
"2500";"1636132";"2018-03-12";"87576";"2018-03-12";"H-852-17   OTROSI NRO 001";"46000";"45080";"920";"0";"0";"0";"0";"0";"0";"0";"45080";"46000";"-920"
"2501";"1636155";"2018-03-12";"87576";"2018-03-12";"H-852-17   OTROSI NRO 001";"180000";"176400";"3600";"0";"0";"0";"0";"0";"0";"0";"176400";"180000";"-3600"
"2502";"1636160";"2018-03-12";"87576";"2018-03-12";"H-852-17   OTROSI NRO 001";"46000";"45080";"920";"0";"0";"0";"0";"0";"0";"0";"45080";"46000";"-920"
"2503";"1636255";"2018-03-12";"87576";"2018-03-12";"H-852-17   OTROSI NRO 001";"46000";"45080";"920";"0";"0";"0";"0";"0";"0";"0";"45080";"46000";"-920"
"2504";"1636395";"2018-03-12";"87576";"2018-03-12";"H-852-17   OTROSI NRO 001";"70000";"68600";"1400";"0";"0";"0";"0";"0";"0";"0";"68600";"70000";"-1400"
"2505";"1636396";"2018-03-12";"87576";"2018-03-12";"H-852-17   OTROSI NRO 001";"46000";"45080";"920";"0";"0";"0";"0";"0";"0";"0";"45080";"46000";"-920"
"2506";"1636398";"2018-03-12";"87576";"2018-03-12";"H-852-17   OTROSI NRO 001";"46000";"45080";"920";"0";"0";"0";"0";"0";"0";"0";"45080";"46000";"-920"
"2507";"1636401";"2018-03-12";"87576";"2018-03-12";"H-852-17   OTROSI NRO 001";"180000";"176400";"3600";"0";"0";"0";"0";"0";"0";"0";"176400";"180000";"-3600"
"2508";"1636943";"2018-03-12";"87576";"2018-03-12";"H-852-17   OTROSI NRO 001";"46000";"45080";"920";"0";"0";"0";"0";"0";"0";"0";"45080";"46000";"-920"
"2509";"1636949";"2018-03-12";"87576";"2018-03-12";"H-852-17   OTROSI NRO 001";"90000";"88200";"1800";"0";"0";"0";"0";"0";"0";"0";"88200";"90000";"-1800"
"2510";"1636956";"2018-03-12";"87576";"2018-03-12";"H-852-17   OTROSI NRO 001";"35900";"35182";"718";"0";"0";"0";"0";"0";"0";"0";"35182";"35900";"-718"
"2511";"1637180";"2018-03-12";"87576";"2018-03-12";"H-852-17   OTROSI NRO 001";"56000";"54880";"1120";"0";"0";"0";"0";"0";"0";"0";"54880";"56000";"-1120"
"2512";"1637213";"2018-03-12";"87576";"2018-03-12";"H-852-17   OTROSI NRO 001";"35000";"34300";"700";"0";"0";"0";"0";"0";"0";"0";"34300";"35000";"-700"
"2513";"1637314";"2018-03-12";"87576";"2018-03-12";"H-852-17   OTROSI NRO 001";"56000";"54880";"1120";"0";"0";"0";"0";"0";"0";"0";"54880";"56000";"-1120"
"2514";"1637376";"2018-03-12";"87576";"2018-03-12";"H-852-17   OTROSI NRO 001";"46000";"45080";"920";"0";"0";"0";"0";"0";"0";"0";"45080";"46000";"-920"
"2515";"1626833";"2018-03-12";"87580";"2018-03-12";"H-852-17   OTROSI NRO 001";"46000";"45080";"920";"0";"0";"0";"0";"0";"0";"0";"45080";"46000";"-920"
"2516";"1627707";"2018-03-12";"87580";"2018-03-12";"H-852-17   OTROSI NRO 001";"300149";"294146";"6003";"0";"0";"0";"0";"0";"0";"0";"294146";"300149";"-6003"
"2517";"1629522";"2018-03-12";"87580";"2018-03-12";"H-852-17   OTROSI NRO 001";"450849";"441832";"9017";"0";"0";"0";"0";"0";"0";"0";"441832";"450849";"-9017"
"2518";"1629601";"2018-03-12";"87580";"2018-03-12";"H-852-17   OTROSI NRO 001";"300149";"294146";"6003";"0";"0";"0";"0";"0";"0";"0";"294146";"300149";"-6003"
"2519";"1630245";"2018-03-12";"87580";"2018-03-12";"H-852-17   OTROSI NRO 001";"46000";"45080";"920";"0";"0";"0";"0";"0";"0";"0";"45080";"46000";"-920"
"2520";"1630255";"2018-03-12";"87580";"2018-03-12";"H-852-17   OTROSI NRO 001";"70000";"68600";"1400";"0";"0";"0";"0";"0";"0";"0";"68600";"70000";"-1400"
"2521";"1630512";"2018-03-12";"87580";"2018-03-12";"H-852-17   OTROSI NRO 001";"46000";"45080";"920";"0";"0";"0";"0";"0";"0";"0";"45080";"46000";"-920"
"2522";"1630513";"2018-03-12";"87580";"2018-03-12";"H-852-17   OTROSI NRO 001";"46000";"45080";"920";"0";"0";"0";"0";"0";"0";"0";"45080";"46000";"-920"
"2523";"1630646";"2018-03-12";"87580";"2018-03-12";"H-852-17   OTROSI NRO 001";"46000";"45080";"920";"0";"0";"0";"0";"0";"0";"0";"45080";"46000";"-920"
"2524";"1630664";"2018-03-12";"87580";"2018-03-12";"H-852-17   OTROSI NRO 001";"458139";"448976";"9163";"0";"0";"0";"0";"0";"0";"0";"448976";"458139";"-9163"
"2525";"1630898";"2018-03-12";"87580";"2018-03-12";"H-852-17   OTROSI NRO 001";"70000";"68600";"1400";"0";"0";"0";"0";"0";"0";"0";"68600";"70000";"-1400"
"2526";"1630900";"2018-03-12";"87580";"2018-03-12";"H-852-17   OTROSI NRO 001";"70000";"68600";"1400";"0";"0";"0";"0";"0";"0";"0";"68600";"70000";"-1400"
"2527";"1630993";"2018-03-12";"87580";"2018-03-12";"H-852-17   OTROSI NRO 001";"46000";"45080";"920";"0";"0";"0";"0";"0";"0";"0";"45080";"46000";"-920"
"2528";"1631247";"2018-03-12";"87580";"2018-03-12";"H-852-17   OTROSI NRO 001";"46000";"45080";"920";"0";"0";"0";"0";"0";"0";"0";"45080";"46000";"-920"
"2529";"1631252";"2018-03-12";"87580";"2018-03-12";"H-852-17   OTROSI NRO 001";"46000";"45080";"920";"0";"0";"0";"0";"0";"0";"0";"45080";"46000";"-920"
"2530";"1631276";"2018-03-12";"87580";"2018-03-12";"H-852-17   OTROSI NRO 001";"46000";"45080";"920";"0";"0";"0";"0";"0";"0";"0";"45080";"46000";"-920"
"2531";"1631291";"2018-03-12";"87580";"2018-03-12";"H-852-17   OTROSI NRO 001";"46000";"45080";"920";"0";"0";"0";"0";"0";"0";"0";"45080";"46000";"-920"
"2532";"1631459";"2018-03-12";"87580";"2018-03-12";"H-852-17   OTROSI NRO 001";"56000";"54880";"1120";"0";"0";"0";"0";"0";"0";"0";"54880";"56000";"-1120"
"2533";"1631581";"2018-03-12";"87580";"2018-03-12";"H-852-17   OTROSI NRO 001";"35000";"34300";"700";"0";"0";"0";"0";"0";"0";"0";"34300";"35000";"-700"
"2534";"1631618";"2018-03-12";"87580";"2018-03-12";"H-852-17   OTROSI NRO 001";"70000";"68600";"1400";"0";"0";"0";"0";"0";"0";"0";"68600";"70000";"-1400"
"2535";"1631629";"2018-03-12";"87580";"2018-03-12";"H-852-17   OTROSI NRO 001";"46000";"45080";"920";"0";"0";"0";"0";"0";"0";"0";"45080";"46000";"-920"
"2536";"1631667";"2018-03-12";"87580";"2018-03-12";"H-852-17   OTROSI NRO 001";"56000";"54880";"1120";"0";"0";"0";"0";"0";"0";"0";"54880";"56000";"-1120"
"2537";"1631719";"2018-03-12";"87580";"2018-03-12";"H-852-17   OTROSI NRO 001";"56000";"54880";"1120";"0";"0";"0";"0";"0";"0";"0";"54880";"56000";"-1120"
"2538";"1631730";"2018-03-12";"87580";"2018-03-12";"H-852-17   OTROSI NRO 001";"114848";"112551";"2297";"0";"0";"0";"0";"0";"0";"0";"112551";"114848";"-2297"
"2539";"1631735";"2018-03-12";"87580";"2018-03-12";"H-852-17   OTROSI NRO 001";"46000";"45080";"920";"0";"0";"0";"0";"0";"0";"0";"45080";"46000";"-920"
"2540";"1631751";"2018-03-12";"87580";"2018-03-12";"H-852-17   OTROSI NRO 001";"46000";"45080";"920";"0";"0";"0";"0";"0";"0";"0";"45080";"46000";"-920"
"2541";"1631752";"2018-03-12";"87580";"2018-03-12";"H-852-17   OTROSI NRO 001";"185343";"181636";"3707";"0";"0";"0";"0";"0";"0";"0";"181636";"185343";"-3707"
"2542";"1631781";"2018-03-12";"87580";"2018-03-12";"H-852-17   OTROSI NRO 001";"114848";"112551";"2297";"0";"0";"0";"0";"0";"0";"0";"112551";"114848";"-2297"
"2543";"1631847";"2018-03-12";"87580";"2018-03-12";"H-852-17   OTROSI NRO 001";"35900";"35182";"718";"0";"0";"0";"0";"0";"0";"0";"35182";"35900";"-718"
"2544";"1632042";"2018-03-12";"87580";"2018-03-12";"H-852-17   OTROSI NRO 001";"46000";"45080";"920";"0";"0";"0";"0";"0";"0";"0";"45080";"46000";"-920"
"2545";"1633080";"2018-03-12";"87580";"2018-03-12";"H-852-17   OTROSI NRO 001";"38364";"37597";"767";"0";"0";"0";"0";"0";"0";"0";"37597";"38364";"-767"
"2546";"1633267";"2018-03-12";"87580";"2018-03-12";"H-852-17   OTROSI NRO 001";"46000";"45080";"920";"0";"0";"0";"0";"0";"0";"0";"45080";"46000";"-920"
"2547";"1639543";"2018-03-12";"87710";"2018-03-12";"H-852-17   OTROSI NRO 001";"46000";"45080";"920";"0";"0";"0";"0";"0";"0";"0";"45080";"46000";"-920"
"2548";"1639937";"2018-03-12";"87710";"2018-03-12";"H-852-17   OTROSI NRO 001";"46000";"45080";"920";"0";"0";"0";"0";"0";"0";"0";"45080";"46000";"-920"
"2549";"1639949";"2018-03-12";"87710";"2018-03-12";"H-852-17   OTROSI NRO 001";"46000";"45080";"920";"0";"0";"0";"0";"0";"0";"0";"45080";"46000";"-920"
"2550";"1639983";"2018-03-12";"87710";"2018-03-12";"H-852-17   OTROSI NRO 001";"46000";"45080";"920";"0";"0";"0";"0";"0";"0";"0";"45080";"46000";"-920"
"2551";"1640030";"2018-03-12";"87710";"2018-03-12";"H-852-17   OTROSI NRO 001";"46000";"45080";"920";"0";"0";"0";"0";"0";"0";"0";"45080";"46000";"-920"
"2552";"1640032";"2018-03-12";"87710";"2018-03-12";"H-852-17   OTROSI NRO 001";"46000";"45080";"920";"0";"0";"0";"0";"0";"0";"0";"45080";"46000";"-920"
"2553";"1640038";"2018-03-12";"87710";"2018-03-12";"H-852-17   OTROSI NRO 001";"46000";"45080";"920";"0";"0";"0";"0";"0";"0";"0";"45080";"46000";"-920"
"2554";"1640042";"2018-03-12";"87710";"2018-03-12";"H-852-17   OTROSI NRO 001";"46000";"45080";"920";"0";"0";"0";"0";"0";"0";"0";"45080";"46000";"-920"
"2555";"1640327";"2018-03-12";"87710";"2018-03-12";"H-852-17   OTROSI NRO 001";"46000";"45080";"920";"0";"0";"0";"0";"0";"0";"0";"45080";"46000";"-920"
"2556";"1640330";"2018-03-12";"87710";"2018-03-12";"H-852-17   OTROSI NRO 001";"46000";"45080";"920";"0";"0";"0";"0";"0";"0";"0";"45080";"46000";"-920"
"2557";"1640335";"2018-03-12";"87710";"2018-03-12";"H-852-17   OTROSI NRO 001";"35000";"34300";"700";"0";"0";"0";"0";"0";"0";"0";"34300";"35000";"-700"
"2558";"1640444";"2018-03-12";"87710";"2018-03-12";"H-852-17   OTROSI NRO 001";"46000";"45080";"920";"0";"0";"0";"0";"0";"0";"0";"45080";"46000";"-920"
"2559";"1640561";"2018-03-12";"87710";"2018-03-12";"H-852-17   OTROSI NRO 001";"46000";"45080";"920";"0";"0";"0";"0";"0";"0";"0";"45080";"46000";"-920"
"2560";"1640590";"2018-03-12";"87710";"2018-03-12";"H-852-17   OTROSI NRO 001";"56000";"54880";"1120";"0";"0";"0";"0";"0";"0";"0";"54880";"56000";"-1120"
"2561";"1640615";"2018-03-12";"87710";"2018-03-12";"H-852-17   OTROSI NRO 001";"46000";"45080";"920";"0";"0";"0";"0";"0";"0";"0";"45080";"46000";"-920"
"2562";"1640619";"2018-03-12";"87710";"2018-03-12";"H-852-17   OTROSI NRO 001";"46000";"45080";"920";"0";"0";"0";"0";"0";"0";"0";"45080";"46000";"-920"
"2563";"1640634";"2018-03-12";"87710";"2018-03-12";"H-852-17   OTROSI NRO 001";"46000";"45080";"920";"0";"0";"0";"0";"0";"0";"0";"45080";"46000";"-920"
"2564";"1640641";"2018-03-12";"87710";"2018-03-12";"H-852-17   OTROSI NRO 001";"46000";"45080";"920";"0";"0";"0";"0";"0";"0";"0";"45080";"46000";"-920"
"2565";"1640646";"2018-03-12";"87710";"2018-03-12";"H-852-17   OTROSI NRO 001";"46000";"45080";"920";"0";"0";"0";"0";"0";"0";"0";"45080";"46000";"-920"
"2566";"1640781";"2018-03-12";"87710";"2018-03-12";"H-852-17   OTROSI NRO 001";"311000";"304780";"6220";"0";"0";"0";"0";"0";"0";"0";"304780";"311000";"-6220"
"2567";"1640816";"2018-03-12";"87710";"2018-03-12";"H-852-17   OTROSI NRO 001";"46000";"45080";"920";"0";"0";"0";"0";"0";"0";"0";"45080";"46000";"-920"
"2568";"1640825";"2018-03-12";"87710";"2018-03-12";"H-852-17   OTROSI NRO 001";"46000";"45080";"920";"0";"0";"0";"0";"0";"0";"0";"45080";"46000";"-920"
"2569";"1640828";"2018-03-12";"87710";"2018-03-12";"H-852-17   OTROSI NRO 001";"70000";"68600";"1400";"0";"0";"0";"0";"0";"0";"0";"68600";"70000";"-1400"
"2570";"1640959";"2018-03-12";"87710";"2018-03-12";"H-852-17   OTROSI NRO 001";"56000";"54880";"1120";"0";"0";"0";"0";"0";"0";"0";"54880";"56000";"-1120"
"2571";"1640960";"2018-03-12";"87710";"2018-03-12";"H-852-17   OTROSI NRO 001";"46000";"45080";"920";"0";"0";"0";"0";"0";"0";"0";"45080";"46000";"-920"
"2572";"1641004";"2018-03-12";"87710";"2018-03-12";"H-852-17   OTROSI NRO 001";"70000";"68600";"1400";"0";"0";"0";"0";"0";"0";"0";"68600";"70000";"-1400"
"2573";"1641030";"2018-03-12";"87710";"2018-03-12";"H-852-17   OTROSI NRO 001";"70000";"68600";"1400";"0";"0";"0";"0";"0";"0";"0";"68600";"70000";"-1400"
"2574";"1641040";"2018-03-12";"87710";"2018-03-12";"H-852-17   OTROSI NRO 001";"70000";"68600";"1400";"0";"0";"0";"0";"0";"0";"0";"68600";"70000";"-1400"
"2575";"1641048";"2018-03-12";"87710";"2018-03-12";"H-852-17   OTROSI NRO 001";"46000";"45080";"920";"0";"0";"0";"0";"0";"0";"0";"45080";"46000";"-920"
"2576";"1641070";"2018-03-12";"87710";"2018-03-12";"H-852-17   OTROSI NRO 001";"56000";"54880";"1120";"0";"0";"0";"0";"0";"0";"0";"54880";"56000";"-1120"
"2577";"1641159";"2018-03-12";"87710";"2018-03-12";"H-852-17   OTROSI NRO 001";"56000";"54880";"1120";"0";"0";"0";"0";"0";"0";"0";"54880";"56000";"-1120"
"2578";"1641219";"2018-03-12";"87710";"2018-03-12";"H-852-17   OTROSI NRO 001";"46000";"45080";"920";"0";"0";"0";"0";"0";"0";"0";"45080";"46000";"-920"
"2579";"1641239";"2018-03-12";"87710";"2018-03-12";"H-852-17   OTROSI NRO 001";"46000";"45080";"920";"0";"0";"0";"0";"0";"0";"0";"45080";"46000";"-920"
"2580";"1641245";"2018-03-12";"87710";"2018-03-12";"H-852-17   OTROSI NRO 001";"70000";"68600";"1400";"0";"0";"0";"0";"0";"0";"0";"68600";"70000";"-1400"
"2581";"1632649";"2018-03-12";"87586";"2018-03-12";"H-852-17   OTROSI NRO 001";"46000";"45080";"920";"0";"0";"0";"0";"0";"0";"0";"45080";"46000";"-920"
"2582";"1634105";"2018-03-12";"87586";"2018-03-12";"H-852-17   OTROSI NRO 001";"46000";"45080";"920";"0";"0";"0";"0";"0";"0";"0";"45080";"46000";"-920"
"2583";"1634496";"2018-03-12";"87586";"2018-03-12";"H-852-17   OTROSI NRO 001";"35000";"34300";"700";"0";"0";"0";"0";"0";"0";"0";"34300";"35000";"-700"
"2584";"1634518";"2018-03-12";"87586";"2018-03-12";"H-852-17   OTROSI NRO 001";"56000";"54880";"1120";"0";"0";"0";"0";"0";"0";"0";"54880";"56000";"-1120"
"2585";"1634523";"2018-03-12";"87586";"2018-03-12";"H-852-17   OTROSI NRO 001";"35000";"34300";"700";"0";"0";"0";"0";"0";"0";"0";"34300";"35000";"-700"
"2586";"1634544";"2018-03-12";"87586";"2018-03-12";"H-852-17   OTROSI NRO 001";"46000";"45080";"920";"0";"0";"0";"0";"0";"0";"0";"45080";"46000";"-920"
"2587";"1635350";"2018-03-12";"87586";"2018-03-12";"H-852-17   OTROSI NRO 001";"2605622";"2553510";"52112";"0";"0";"0";"0";"0";"0";"0";"2553510";"2605622";"-52112"
"2588";"1636933";"2018-03-12";"87586";"2018-03-12";"H-852-17   OTROSI NRO 001";"35000";"34300";"700";"0";"0";"0";"0";"0";"0";"0";"34300";"35000";"-700"
"2589";"1636938";"2018-03-12";"87586";"2018-03-12";"H-852-17   OTROSI NRO 001";"46000";"45080";"920";"0";"0";"0";"0";"0";"0";"0";"45080";"46000";"-920"
"2590";"1636940";"2018-03-12";"87586";"2018-03-12";"H-852-17   OTROSI NRO 001";"56000";"54880";"1120";"0";"0";"0";"0";"0";"0";"0";"54880";"56000";"-1120"
"2591";"1636947";"2018-03-12";"87586";"2018-03-12";"H-852-17   OTROSI NRO 001";"46000";"45080";"920";"0";"0";"0";"0";"0";"0";"0";"45080";"46000";"-920"
"2592";"1637052";"2018-03-12";"87586";"2018-03-12";"H-852-17   OTROSI NRO 001";"56000";"54880";"1120";"0";"0";"0";"0";"0";"0";"0";"54880";"56000";"-1120"
"2593";"1638461";"2018-03-12";"87586";"2018-03-12";"H-852-17   OTROSI NRO 001";"14594";"14302";"292";"0";"0";"0";"0";"0";"0";"0";"14302";"14594";"-292"
"2594";"1638465";"2018-03-12";"87586";"2018-03-12";"H-852-17   OTROSI NRO 001";"14594";"14302";"292";"0";"0";"0";"0";"0";"0";"0";"14302";"14594";"-292"
"2595";"1638468";"2018-03-12";"87586";"2018-03-12";"H-852-17   OTROSI NRO 001";"14594";"14302";"292";"0";"0";"0";"0";"0";"0";"0";"14302";"14594";"-292"
"2596";"1640273";"2018-03-12";"87586";"2018-03-12";"H-852-17   OTROSI NRO 001";"552709";"541655";"11054";"0";"0";"0";"0";"0";"0";"0";"541655";"552709";"-11054"
"2597";"1640325";"2018-03-12";"87586";"2018-03-12";"H-852-17   OTROSI NRO 001";"46000";"45080";"920";"0";"0";"0";"0";"0";"0";"0";"45080";"46000";"-920"
"2598";"1640360";"2018-03-12";"87586";"2018-03-12";"H-852-17   OTROSI NRO 001";"46000";"45080";"920";"0";"0";"0";"0";"0";"0";"0";"45080";"46000";"-920"
"2599";"1640384";"2018-03-12";"87586";"2018-03-12";"H-852-17   OTROSI NRO 001";"46000";"45080";"920";"0";"0";"0";"0";"0";"0";"0";"45080";"46000";"-920"
"2600";"1640427";"2018-03-12";"87586";"2018-03-12";"H-852-17   OTROSI NRO 001";"35000";"34300";"700";"0";"0";"0";"0";"0";"0";"0";"34300";"35000";"-700"
"2601";"1640508";"2018-03-12";"87586";"2018-03-12";"H-852-17   OTROSI NRO 001";"35770";"35055";"715";"0";"0";"0";"0";"0";"0";"0";"35055";"35770";"-715"
"2602";"1640549";"2018-03-12";"87586";"2018-03-12";"H-852-17   OTROSI NRO 001";"46000";"45080";"920";"0";"0";"0";"0";"0";"0";"0";"45080";"46000";"-920"
"2603";"1640623";"2018-03-12";"87586";"2018-03-12";"H-852-17   OTROSI NRO 001";"46000";"45080";"920";"0";"0";"0";"0";"0";"0";"0";"45080";"46000";"-920"
"2604";"1640628";"2018-03-12";"87586";"2018-03-12";"H-852-17   OTROSI NRO 001";"70000";"68600";"1400";"0";"0";"0";"0";"0";"0";"0";"68600";"70000";"-1400"
"2605";"1640728";"2018-03-12";"87586";"2018-03-12";"H-852-17   OTROSI NRO 001";"46000";"45080";"920";"0";"0";"0";"0";"0";"0";"0";"45080";"46000";"-920"
"2606";"1640734";"2018-03-12";"87586";"2018-03-12";"H-852-17   OTROSI NRO 001";"46000";"45080";"920";"0";"0";"0";"0";"0";"0";"0";"45080";"46000";"-920"
"2607";"1640779";"2018-03-12";"87586";"2018-03-12";"H-852-17   OTROSI NRO 001";"35000";"34300";"700";"0";"0";"0";"0";"0";"0";"0";"34300";"35000";"-700"
"2608";"1640812";"2018-03-12";"87586";"2018-03-12";"H-852-17   OTROSI NRO 001";"46000";"45080";"920";"0";"0";"0";"0";"0";"0";"0";"45080";"46000";"-920"
"2609";"1640814";"2018-03-12";"87586";"2018-03-12";"H-852-17   OTROSI NRO 001";"46000";"45080";"920";"0";"0";"0";"0";"0";"0";"0";"45080";"46000";"-920"
"2610";"1640950";"2018-03-12";"87586";"2018-03-12";"H-852-17   OTROSI NRO 001";"46000";"45080";"920";"0";"0";"0";"0";"0";"0";"0";"45080";"46000";"-920"
"2611";"1641023";"2018-03-12";"87586";"2018-03-12";"H-852-17   OTROSI NRO 001";"70000";"68600";"1400";"0";"0";"0";"0";"0";"0";"0";"68600";"70000";"-1400"
"2612";"1641243";"2018-03-12";"87586";"2018-03-12";"H-852-17   OTROSI NRO 001";"46000";"45080";"920";"0";"0";"0";"0";"0";"0";"0";"45080";"46000";"-920"
"2613";"1641253";"2018-03-12";"87586";"2018-03-12";"H-852-17   OTROSI NRO 001";"56000";"54880";"1120";"0";"0";"0";"0";"0";"0";"0";"54880";"56000";"-1120"
"2614";"1606041";"2018-03-12";"88491";"2018-03-12";"H-852-17";"1220597";"1196185";"24412";"0";"0";"0";"0";"0";"0";"0";"1196185";"1220597";"-24412"
"2615";"1636617";"2018-03-12";"88020";"2018-03-12";"H-852-17   OTROSI NRO 001";"274200";"268716";"5484";"0";"0";"0";"0";"0";"0";"0";"268716";"274200";"-5484"
"2616";"1636643";"2018-03-12";"88020";"2018-03-12";"H-852-17   OTROSI NRO 001";"274200";"268716";"5484";"0";"0";"0";"0";"0";"0";"0";"268716";"274200";"-5484"
"2617";"1636670";"2018-03-12";"88020";"2018-03-12";"H-852-17   OTROSI NRO 001";"274200";"268716";"5484";"0";"0";"0";"0";"0";"0";"0";"268716";"274200";"-5484"
"2618";"1637365";"2018-03-12";"88020";"2018-03-12";"H-852-17   OTROSI NRO 001";"274200";"268716";"5484";"0";"0";"0";"0";"0";"0";"0";"268716";"274200";"-5484"
"2619";"1637392";"2018-03-12";"88020";"2018-03-12";"H-852-17   OTROSI NRO 001";"548400";"537432";"10968";"0";"0";"0";"0";"0";"0";"0";"537432";"548400";"-10968"
"2620";"1640532";"2018-03-12";"88020";"2018-03-12";"H-852-17   OTROSI NRO 001";"548400";"537432";"10968";"0";"0";"0";"0";"0";"0";"0";"537432";"548400";"-10968"
"2621";"1642316";"2018-03-12";"88020";"2018-03-12";"H-852-17   OTROSI NRO 001";"548400";"537432";"10968";"0";"0";"0";"0";"0";"0";"0";"537432";"548400";"-10968"
"2622";"1646449";"2018-03-12";"88020";"2018-03-12";"H-852-17   OTROSI NRO 001";"46000";"45080";"920";"0";"0";"0";"0";"0";"0";"0";"45080";"46000";"-920"
"2623";"1646505";"2018-03-12";"88020";"2018-03-12";"H-852-17   OTROSI NRO 001";"46000";"45080";"920";"0";"0";"0";"0";"0";"0";"0";"45080";"46000";"-920"
"2624";"1646517";"2018-03-12";"88020";"2018-03-12";"H-852-17   OTROSI NRO 001";"70000";"68600";"1400";"0";"0";"0";"0";"0";"0";"0";"68600";"70000";"-1400"
"2625";"1646770";"2018-03-12";"88020";"2018-03-12";"H-852-17   OTROSI NRO 001";"46000";"45080";"920";"0";"0";"0";"0";"0";"0";"0";"45080";"46000";"-920"
"2626";"1646788";"2018-03-12";"88020";"2018-03-12";"H-852-17   OTROSI NRO 001";"180000";"176400";"3600";"0";"0";"0";"0";"0";"0";"0";"176400";"180000";"-3600"
"2627";"1646828";"2018-03-12";"88020";"2018-03-12";"H-852-17   OTROSI NRO 001";"180000";"176400";"3600";"0";"0";"0";"0";"0";"0";"0";"176400";"180000";"-3600"
"2628";"1646842";"2018-03-12";"88020";"2018-03-12";"H-852-17   OTROSI NRO 001";"46000";"45080";"920";"0";"0";"0";"0";"0";"0";"0";"45080";"46000";"-920"
"2629";"1646942";"2018-03-12";"88020";"2018-03-12";"H-852-17   OTROSI NRO 001";"46000";"45080";"920";"0";"0";"0";"0";"0";"0";"0";"45080";"46000";"-920"
"2630";"1647131";"2018-03-12";"88020";"2018-03-12";"H-852-17   OTROSI NRO 001";"46000";"45080";"920";"0";"0";"0";"0";"0";"0";"0";"45080";"46000";"-920"
"2631";"1647222";"2018-03-12";"88020";"2018-03-12";"H-852-17   OTROSI NRO 001";"46000";"45080";"920";"0";"0";"0";"0";"0";"0";"0";"45080";"46000";"-920"
"2632";"1647263";"2018-03-12";"88020";"2018-03-12";"H-852-17   OTROSI NRO 001";"46000";"45080";"920";"0";"0";"0";"0";"0";"0";"0";"45080";"46000";"-920"
"2633";"1647446";"2018-03-12";"88020";"2018-03-12";"H-852-17   OTROSI NRO 001";"56000";"54880";"1120";"0";"0";"0";"0";"0";"0";"0";"54880";"56000";"-1120"
"2634";"1647552";"2018-03-12";"88020";"2018-03-12";"H-852-17   OTROSI NRO 001";"56000";"54880";"1120";"0";"0";"0";"0";"0";"0";"0";"54880";"56000";"-1120"
"2635";"1643373";"2018-03-13";"88463";"2018-03-13";"H-852-17   OTROSI NRO 001";"1102758";"1080703";"22055";"0";"0";"0";"61400";"61400";"0";"0";"1019303";"1041358";"-22055"
"2636";"1643752";"2018-03-13";"88463";"2018-03-13";"H-852-17   OTROSI NRO 001";"26837955";"26301196";"536759";"0";"0";"0";"14547858";"7405996";"7141862";"0";"18895200";"12290097";"6605103"
"2637";"1646314";"2018-03-13";"88463";"2018-03-13";"H-852-17   OTROSI NRO 001";"6187647";"6063894";"123753";"0";"0";"0";"1125070";"831120";"293950";"0";"5232774";"5062577";"170197"
"2638";"1637390";"2018-03-13";"87941";"2018-03-13";"H-852-17   OTROSI NRO 001";"274200";"268716";"5484";"0";"0";"0";"0";"0";"0";"0";"268716";"274200";"-5484"
"2639";"1638448";"2018-03-13";"87941";"2018-03-13";"H-852-17   OTROSI NRO 001";"777948";"762389";"15559";"0";"0";"0";"300149";"0";"300149";"0";"762389";"300149";"462240"
"2640";"1639163";"2018-03-13";"87941";"2018-03-13";"H-852-17   OTROSI NRO 001";"35900";"35182";"718";"0";"0";"0";"0";"0";"0";"0";"35182";"35900";"-718"
"2641";"1639408";"2018-03-13";"87941";"2018-03-13";"H-852-17   OTROSI NRO 001";"458139";"448976";"9163";"0";"0";"0";"0";"0";"0";"0";"448976";"458139";"-9163"
"2642";"1640383";"2018-03-13";"87941";"2018-03-13";"H-852-17   OTROSI NRO 001";"46000";"45080";"920";"0";"0";"0";"0";"0";"0";"0";"45080";"46000";"-920"
"2643";"1642692";"2018-03-13";"87941";"2018-03-13";"H-852-17   OTROSI NRO 001";"35000";"34300";"700";"0";"0";"0";"0";"0";"0";"0";"34300";"35000";"-700"
"2644";"1642999";"2018-03-13";"87941";"2018-03-13";"H-852-17   OTROSI NRO 001";"56000";"54880";"1120";"0";"0";"0";"0";"0";"0";"0";"54880";"56000";"-1120"
"2645";"1643001";"2018-03-13";"87941";"2018-03-13";"H-852-17   OTROSI NRO 001";"56000";"54880";"1120";"0";"0";"0";"0";"0";"0";"0";"54880";"56000";"-1120"
"2646";"1643002";"2018-03-13";"87941";"2018-03-13";"H-852-17   OTROSI NRO 001";"56000";"54880";"1120";"0";"0";"0";"0";"0";"0";"0";"54880";"56000";"-1120"
"2647";"1643111";"2018-03-13";"87941";"2018-03-13";"H-852-17   OTROSI NRO 001";"56000";"54880";"1120";"0";"0";"0";"0";"0";"0";"0";"54880";"56000";"-1120"
"2648";"1643120";"2018-03-13";"87941";"2018-03-13";"H-852-17   OTROSI NRO 001";"70000";"68600";"1400";"0";"0";"0";"0";"0";"0";"0";"68600";"70000";"-1400"
"2649";"1643146";"2018-03-13";"87941";"2018-03-13";"H-852-17   OTROSI NRO 001";"35000";"34300";"700";"0";"0";"0";"0";"0";"0";"0";"34300";"35000";"-700"
"2650";"1643228";"2018-03-13";"87941";"2018-03-13";"H-852-17   OTROSI NRO 001";"46000";"45080";"920";"0";"0";"0";"0";"0";"0";"0";"45080";"46000";"-920"
"2651";"1643295";"2018-03-13";"87941";"2018-03-13";"H-852-17   OTROSI NRO 001";"56000";"54880";"1120";"0";"0";"0";"0";"0";"0";"0";"54880";"56000";"-1120"
"2652";"1643303";"2018-03-13";"87941";"2018-03-13";"H-852-17   OTROSI NRO 001";"56000";"54880";"1120";"0";"0";"0";"0";"0";"0";"0";"54880";"56000";"-1120"
"2653";"1643319";"2018-03-13";"87941";"2018-03-13";"H-852-17   OTROSI NRO 001";"180000";"176400";"3600";"0";"0";"0";"0";"0";"0";"0";"176400";"180000";"-3600"
"2654";"1643450";"2018-03-13";"87941";"2018-03-13";"H-852-17   OTROSI NRO 001";"56000";"54880";"1120";"0";"0";"0";"0";"0";"0";"0";"54880";"56000";"-1120"
"2655";"1643461";"2018-03-13";"87941";"2018-03-13";"H-852-17   OTROSI NRO 001";"56000";"54880";"1120";"0";"0";"0";"0";"0";"0";"0";"54880";"56000";"-1120"
"2656";"1644134";"2018-03-13";"87941";"2018-03-13";"H-852-17   OTROSI NRO 001";"46000";"45080";"920";"0";"0";"0";"0";"0";"0";"0";"45080";"46000";"-920"
"2657";"1644144";"2018-03-13";"87941";"2018-03-13";"H-852-17   OTROSI NRO 001";"56000";"54880";"1120";"0";"0";"0";"0";"0";"0";"0";"54880";"56000";"-1120"
"2658";"1644780";"2018-03-13";"87941";"2018-03-13";"H-852-17   OTROSI NRO 001";"35000";"34300";"700";"0";"0";"0";"0";"0";"0";"0";"34300";"35000";"-700"
"2659";"1644868";"2018-03-13";"87941";"2018-03-13";"H-852-17   OTROSI NRO 001";"46000";"45080";"920";"0";"0";"0";"0";"0";"0";"0";"45080";"46000";"-920"
"2660";"1644881";"2018-03-13";"87941";"2018-03-13";"H-852-17   OTROSI NRO 001";"56000";"54880";"1120";"0";"0";"0";"0";"0";"0";"0";"54880";"56000";"-1120"
"2661";"1644967";"2018-03-13";"87941";"2018-03-13";"H-852-17   OTROSI NRO 001";"46000";"45080";"920";"0";"0";"0";"0";"0";"0";"0";"45080";"46000";"-920"
"2662";"1644993";"2018-03-13";"87941";"2018-03-13";"H-852-17   OTROSI NRO 001";"35000";"34300";"700";"0";"0";"0";"0";"0";"0";"0";"34300";"35000";"-700"
"2663";"1645100";"2018-03-13";"87941";"2018-03-13";"H-852-17   OTROSI NRO 001";"70000";"68600";"1400";"0";"0";"0";"0";"0";"0";"0";"68600";"70000";"-1400"
"2664";"1645140";"2018-03-13";"87941";"2018-03-13";"H-852-17   OTROSI NRO 001";"56000";"54880";"1120";"0";"0";"0";"0";"0";"0";"0";"54880";"56000";"-1120"
"2665";"1645189";"2018-03-13";"87941";"2018-03-13";"H-852-17   OTROSI NRO 001";"46000";"45080";"920";"0";"0";"0";"0";"0";"0";"0";"45080";"46000";"-920"
"2666";"1645221";"2018-03-13";"87941";"2018-03-13";"H-852-17   OTROSI NRO 001";"46000";"45080";"920";"0";"0";"0";"0";"0";"0";"0";"45080";"46000";"-920"
"2667";"1645244";"2018-03-13";"87941";"2018-03-13";"H-852-17   OTROSI NRO 001";"46000";"45080";"920";"0";"0";"0";"0";"0";"0";"0";"45080";"46000";"-920"
"2668";"1645255";"2018-03-13";"87941";"2018-03-13";"H-852-17   OTROSI NRO 001";"70000";"68600";"1400";"0";"0";"0";"0";"0";"0";"0";"68600";"70000";"-1400"
"2669";"1639882";"2018-03-13";"88332";"2018-03-13";"H-852-17   OTROSI NRO 001";"4529413";"4438825";"90588";"0";"0";"0";"260782";"191232";"69550";"0";"4247593";"69550";"4178043"
"2670";"1644439";"2018-03-13";"88332";"2018-03-13";"H-852-17   OTROSI NRO 001";"35634361";"34921674";"712687";"0";"0";"0";"4035260";"2048625";"1986635";"0";"32873049";"1738085";"31134964"
"2671";"1648558";"2018-03-13";"88234";"2018-03-13";"H-852-17   OTROSI NRO 001";"547765";"536810";"10955";"0";"0";"0";"0";"0";"0";"0";"536810";"547765";"-10955"
"2672";"1648642";"2018-03-13";"88234";"2018-03-13";"H-852-17   OTROSI NRO 001";"882000";"864360";"17640";"0";"0";"0";"0";"0";"0";"0";"864360";"882000";"-17640"
"2673";"1649120";"2018-03-13";"88234";"2018-03-13";"H-852-17   OTROSI NRO 001";"556665";"545532";"11133";"0";"0";"0";"0";"0";"0";"0";"545532";"556665";"-11133"
"2674";"1646763";"2018-03-13";"88402";"2018-03-13";"H-852-17   OTROSI NRO 001";"971200";"951776";"19424";"0";"0";"0";"413920";"0";"413920";"0";"951776";"413920";"537856"
"2675";"1632528";"2018-03-13";"88296";"2018-03-13";"H-852-17   OTROSI NRO 001";"2935208";"2876504";"58704";"0";"0";"0";"14948";"14948";"0";"0";"2861556";"2920260";"-58704"
"2676";"1644196";"2018-03-13";"88296";"2018-03-13";"H-852-17   OTROSI NRO 001";"54200";"53116";"1084";"0";"0";"0";"0";"0";"0";"0";"53116";"54200";"-1084"
"2677";"1645375";"2018-03-13";"88296";"2018-03-13";"H-852-17   OTROSI NRO 001";"52095";"51053";"1042";"0";"0";"0";"0";"0";"0";"0";"51053";"52095";"-1042"
"2678";"1646019";"2018-03-13";"88296";"2018-03-13";"H-852-17   OTROSI NRO 001";"138390";"135622";"2768";"0";"0";"0";"0";"0";"0";"0";"135622";"138390";"-2768"
"2679";"1646883";"2018-03-13";"88296";"2018-03-13";"H-852-17   OTROSI NRO 001";"431705";"423071";"8634";"0";"0";"0";"0";"0";"0";"0";"423071";"431705";"-8634"
"2680";"1650387";"2018-03-13";"88296";"2018-03-13";"H-852-17   OTROSI NRO 001";"37525";"36774";"751";"0";"0";"0";"200";"200";"0";"0";"36574";"37325";"-751"
"2681";"1650552";"2018-03-13";"88296";"2018-03-13";"H-852-17   OTROSI NRO 001";"1534350";"1503663";"30687";"0";"0";"0";"0";"0";"0";"0";"1503663";"1534350";"-30687"
"2682";"1650973";"2018-03-13";"88296";"2018-03-13";"H-852-17   OTROSI NRO 001";"30975";"30355";"620";"0";"0";"0";"0";"0";"0";"0";"30355";"30975";"-620"
"2683";"1636779";"2018-03-13";"87563";"2018-03-13";"H-853-17   OTROSI NRO 001";"71900";"70462";"1438";"0";"0";"0";"0";"0";"0";"0";"70462";"71900";"-1438"
"2684";"1637793";"2018-03-13";"87563";"2018-03-13";"H-853-17   OTROSI NRO 001";"31795";"31159";"636";"0";"0";"0";"0";"0";"0";"0";"31159";"31795";"-636"
"2685";"1641504";"2018-03-13";"87563";"2018-03-13";"H-853-17   OTROSI NRO 001";"37525";"36774";"751";"0";"0";"0";"0";"0";"0";"0";"36774";"37525";"-751"
"2686";"1647816";"2018-03-13";"87563";"2018-03-13";"H-853-17   OTROSI NRO 001";"30800";"30184";"616";"0";"0";"0";"0";"0";"0";"0";"30184";"30800";"-616"
"2687";"1648262";"2018-03-13";"87563";"2018-03-13";"H-853-17   OTROSI NRO 001";"46000";"45080";"920";"0";"0";"0";"0";"0";"0";"0";"45080";"46000";"-920"
"2688";"1649287";"2018-03-13";"87563";"2018-03-13";"H-853-17   OTROSI NRO 001";"37432";"36683";"749";"0";"0";"0";"0";"0";"0";"0";"36683";"37432";"-749"
"2689";"1644382";"2018-03-13";"88177";"2018-03-13";"H-852-17   OTROSI NRO 001";"31657632";"31024479";"633153";"0";"0";"0";"4560283";"1999861";"2560422";"0";"29024618";"1976529";"27048089"
"2690";"1646832";"2018-03-13";"88177";"2018-03-13";"H-852-17   OTROSI NRO 001";"8634866";"8462169";"172697";"0";"0";"0";"891401";"514637";"376764";"0";"7947532";"282916";"7664616"
"2691";"1648754";"2018-03-13";"88335";"2018-03-13";"H-852-17   OTROSI NRO 001";"46000";"45080";"920";"0";"0";"0";"0";"0";"0";"0";"45080";"46000";"-920"
"2692";"1649039";"2018-03-13";"88335";"2018-03-13";"H-852-17   OTROSI NRO 001";"46000";"45080";"920";"0";"0";"0";"0";"0";"0";"0";"45080";"46000";"-920"
"2693";"1649047";"2018-03-13";"88335";"2018-03-13";"H-852-17   OTROSI NRO 001";"56000";"54880";"1120";"0";"0";"0";"0";"0";"0";"0";"54880";"56000";"-1120"
"2694";"1649050";"2018-03-13";"88335";"2018-03-13";"H-852-17   OTROSI NRO 001";"46000";"45080";"920";"0";"0";"0";"0";"0";"0";"0";"45080";"46000";"-920"
"2695";"1649755";"2018-03-13";"88335";"2018-03-13";"H-852-17   OTROSI NRO 001";"20990";"20570";"420";"0";"0";"0";"0";"0";"0";"0";"20570";"20990";"-420"
"2696";"1650194";"2018-03-13";"88335";"2018-03-13";"H-852-17   OTROSI NRO 001";"70000";"68600";"1400";"0";"0";"0";"0";"0";"0";"0";"68600";"70000";"-1400"
"2697";"1650196";"2018-03-13";"88335";"2018-03-13";"H-852-17   OTROSI NRO 001";"70000";"68600";"1400";"0";"0";"0";"0";"0";"0";"0";"68600";"70000";"-1400"
"2698";"1650217";"2018-03-13";"88335";"2018-03-13";"H-852-17   OTROSI NRO 001";"70000";"68600";"1400";"0";"0";"0";"0";"0";"0";"0";"68600";"70000";"-1400"
"2699";"1650245";"2018-03-13";"88335";"2018-03-13";"H-852-17   OTROSI NRO 001";"35000";"34300";"700";"0";"0";"0";"0";"0";"0";"0";"34300";"35000";"-700"
"2700";"1650264";"2018-03-13";"88335";"2018-03-13";"H-852-17   OTROSI NRO 001";"46000";"45080";"920";"0";"0";"0";"0";"0";"0";"0";"45080";"46000";"-920"
"2701";"1650267";"2018-03-13";"88335";"2018-03-13";"H-852-17   OTROSI NRO 001";"46000";"45080";"920";"0";"0";"0";"0";"0";"0";"0";"45080";"46000";"-920"
"2702";"1650268";"2018-03-13";"88335";"2018-03-13";"H-852-17   OTROSI NRO 001";"46000";"45080";"920";"0";"0";"0";"0";"0";"0";"0";"45080";"46000";"-920"
"2703";"1650269";"2018-03-13";"88335";"2018-03-13";"H-852-17   OTROSI NRO 001";"46000";"45080";"920";"0";"0";"0";"0";"0";"0";"0";"45080";"46000";"-920"
"2704";"1650276";"2018-03-13";"88335";"2018-03-13";"H-852-17   OTROSI NRO 001";"14594";"14302";"292";"0";"0";"0";"0";"0";"0";"0";"14302";"14594";"-292"
"2705";"1650295";"2018-03-13";"88335";"2018-03-13";"H-852-17   OTROSI NRO 001";"46000";"45080";"920";"0";"0";"0";"0";"0";"0";"0";"45080";"46000";"-920"
"2706";"1650591";"2018-03-13";"88335";"2018-03-13";"H-852-17   OTROSI NRO 001";"70000";"68600";"1400";"0";"0";"0";"0";"0";"0";"0";"68600";"70000";"-1400"
"2707";"1650659";"2018-03-13";"88335";"2018-03-13";"H-852-17   OTROSI NRO 001";"46000";"45080";"920";"0";"0";"0";"0";"0";"0";"0";"45080";"46000";"-920"
"2708";"1650753";"2018-03-13";"88335";"2018-03-13";"H-852-17   OTROSI NRO 001";"35000";"34300";"700";"0";"0";"0";"0";"0";"0";"0";"34300";"35000";"-700"
"2709";"1650779";"2018-03-13";"88335";"2018-03-13";"H-852-17   OTROSI NRO 001";"46000";"45080";"920";"0";"0";"0";"0";"0";"0";"0";"45080";"46000";"-920"
"2710";"1650893";"2018-03-13";"88335";"2018-03-13";"H-852-17   OTROSI NRO 001";"70000";"68600";"1400";"0";"0";"0";"0";"0";"0";"0";"68600";"70000";"-1400"
"2711";"1650907";"2018-03-13";"88335";"2018-03-13";"H-852-17   OTROSI NRO 001";"46000";"45080";"920";"0";"0";"0";"0";"0";"0";"0";"45080";"46000";"-920"
"2712";"1650964";"2018-03-13";"88335";"2018-03-13";"H-852-17   OTROSI NRO 001";"46000";"45080";"920";"0";"0";"0";"0";"0";"0";"0";"45080";"46000";"-920"
"2713";"1650966";"2018-03-13";"88335";"2018-03-13";"H-852-17   OTROSI NRO 001";"46000";"45080";"920";"0";"0";"0";"0";"0";"0";"0";"45080";"46000";"-920"
"2714";"1651000";"2018-03-13";"88335";"2018-03-13";"H-852-17   OTROSI NRO 001";"46000";"45080";"920";"0";"0";"0";"0";"0";"0";"0";"45080";"46000";"-920"
"2715";"1651023";"2018-03-13";"88335";"2018-03-13";"H-852-17   OTROSI NRO 001";"46000";"45080";"920";"0";"0";"0";"0";"0";"0";"0";"45080";"46000";"-920"
"2716";"1651059";"2018-03-13";"88335";"2018-03-13";"H-852-17   OTROSI NRO 001";"46000";"45080";"920";"0";"0";"0";"0";"0";"0";"0";"45080";"46000";"-920"
"2717";"1651062";"2018-03-13";"88335";"2018-03-13";"H-852-17   OTROSI NRO 001";"46000";"45080";"920";"0";"0";"0";"0";"0";"0";"0";"45080";"46000";"-920"
"2718";"1651164";"2018-03-13";"88335";"2018-03-13";"H-852-17   OTROSI NRO 001";"46000";"45080";"920";"0";"0";"0";"0";"0";"0";"0";"45080";"46000";"-920"
"2719";"1651196";"2018-03-13";"88335";"2018-03-13";"H-852-17   OTROSI NRO 001";"46000";"45080";"920";"0";"0";"0";"0";"0";"0";"0";"45080";"46000";"-920"
"2720";"1651219";"2018-03-13";"88335";"2018-03-13";"H-852-17   OTROSI NRO 001";"46000";"45080";"920";"0";"0";"0";"0";"0";"0";"0";"45080";"46000";"-920"
"2721";"1651249";"2018-03-13";"88335";"2018-03-13";"H-852-17   OTROSI NRO 001";"46000";"45080";"920";"0";"0";"0";"0";"0";"0";"0";"45080";"46000";"-920"
"2722";"1651252";"2018-03-13";"88335";"2018-03-13";"H-852-17   OTROSI NRO 001";"46000";"45080";"920";"0";"0";"0";"0";"0";"0";"0";"45080";"46000";"-920"
"2723";"1651268";"2018-03-13";"88335";"2018-03-13";"H-852-17   OTROSI NRO 001";"46000";"45080";"920";"0";"0";"0";"0";"0";"0";"0";"45080";"46000";"-920"
"2724";"1651273";"2018-03-13";"88335";"2018-03-13";"H-852-17   OTROSI NRO 001";"46000";"45080";"920";"0";"0";"0";"0";"0";"0";"0";"45080";"46000";"-920"
"2725";"1648093";"2018-03-13";"88403";"2018-03-13";"H-852-17   OTROSI NRO 001";"300149";"294146";"6003";"0";"0";"0";"0";"0";"0";"0";"294146";"300149";"-6003"
"2726";"1651497";"2018-03-13";"88403";"2018-03-13";"H-852-17   OTROSI NRO 001";"256890";"251752";"5138";"0";"0";"0";"0";"0";"0";"0";"251752";"256890";"-5138"
"2727";"1651595";"2018-03-13";"88403";"2018-03-13";"H-852-17   OTROSI NRO 001";"180000";"176400";"3600";"0";"0";"0";"0";"0";"0";"0";"176400";"180000";"-3600"
"2728";"1651603";"2018-03-13";"88403";"2018-03-13";"H-852-17   OTROSI NRO 001";"46000";"45080";"920";"0";"0";"0";"0";"0";"0";"0";"45080";"46000";"-920"
"2729";"1651626";"2018-03-13";"88403";"2018-03-13";"H-852-17   OTROSI NRO 001";"46000";"45080";"920";"0";"0";"0";"0";"0";"0";"0";"45080";"46000";"-920"
"2730";"1651692";"2018-03-13";"88403";"2018-03-13";"H-852-17   OTROSI NRO 001";"180000";"176400";"3600";"0";"0";"0";"0";"0";"0";"0";"176400";"180000";"-3600"
"2731";"1651694";"2018-03-13";"88403";"2018-03-13";"H-852-17   OTROSI NRO 001";"180000";"176400";"3600";"0";"0";"0";"0";"0";"0";"0";"176400";"180000";"-3600"
"2732";"1651765";"2018-03-13";"88403";"2018-03-13";"H-852-17   OTROSI NRO 001";"46000";"45080";"920";"0";"0";"0";"0";"0";"0";"0";"45080";"46000";"-920"
"2733";"1651802";"2018-03-13";"88403";"2018-03-13";"H-852-17   OTROSI NRO 001";"311000";"304780";"6220";"0";"0";"0";"0";"0";"0";"0";"304780";"311000";"-6220"
"2734";"1651809";"2018-03-13";"88403";"2018-03-13";"H-852-17   OTROSI NRO 001";"311000";"304780";"6220";"0";"0";"0";"0";"0";"0";"0";"304780";"311000";"-6220"
"2735";"1651893";"2018-03-13";"88403";"2018-03-13";"H-852-17   OTROSI NRO 001";"70000";"68600";"1400";"0";"0";"0";"0";"0";"0";"0";"68600";"70000";"-1400"
"2736";"1651929";"2018-03-13";"88403";"2018-03-13";"H-852-17   OTROSI NRO 001";"70000";"68600";"1400";"0";"0";"0";"0";"0";"0";"0";"68600";"70000";"-1400"
"2737";"1651952";"2018-03-13";"88403";"2018-03-13";"H-852-17   OTROSI NRO 001";"56000";"54880";"1120";"0";"0";"0";"0";"0";"0";"0";"54880";"56000";"-1120"
"2738";"1651984";"2018-03-13";"88403";"2018-03-13";"H-852-17   OTROSI NRO 001";"46000";"45080";"920";"0";"0";"0";"0";"0";"0";"0";"45080";"46000";"-920"
"2739";"1651997";"2018-03-13";"88403";"2018-03-13";"H-852-17   OTROSI NRO 001";"46000";"45080";"920";"0";"0";"0";"0";"0";"0";"0";"45080";"46000";"-920"
"2740";"1652004";"2018-03-13";"88403";"2018-03-13";"H-852-17   OTROSI NRO 001";"46000";"45080";"920";"0";"0";"0";"0";"0";"0";"0";"45080";"46000";"-920"
"2741";"1652060";"2018-03-13";"88403";"2018-03-13";"H-852-17   OTROSI NRO 001";"46000";"45080";"920";"0";"0";"0";"0";"0";"0";"0";"45080";"46000";"-920"
"2742";"1652228";"2018-03-13";"88403";"2018-03-13";"H-852-17   OTROSI NRO 001";"56000";"54880";"1120";"0";"0";"0";"0";"0";"0";"0";"54880";"56000";"-1120"
"2743";"1652285";"2018-03-13";"88403";"2018-03-13";"H-852-17   OTROSI NRO 001";"46000";"45080";"920";"0";"0";"0";"0";"0";"0";"0";"45080";"46000";"-920"
"2744";"1652349";"2018-03-13";"88403";"2018-03-13";"H-852-17   OTROSI NRO 001";"46000";"45080";"920";"0";"0";"0";"0";"0";"0";"0";"45080";"46000";"-920"
"2745";"1652386";"2018-03-13";"88403";"2018-03-13";"H-852-17   OTROSI NRO 001";"46000";"45080";"920";"0";"0";"0";"0";"0";"0";"0";"45080";"46000";"-920"
"2746";"1652627";"2018-03-13";"88403";"2018-03-13";"H-852-17   OTROSI NRO 001";"46000";"45080";"920";"0";"0";"0";"0";"0";"0";"0";"45080";"46000";"-920"
"2747";"1652703";"2018-03-13";"88403";"2018-03-13";"H-852-17   OTROSI NRO 001";"70000";"68600";"1400";"0";"0";"0";"0";"0";"0";"0";"68600";"70000";"-1400"
"2748";"1652709";"2018-03-13";"88403";"2018-03-13";"H-852-17   OTROSI NRO 001";"46000";"45080";"920";"0";"0";"0";"0";"0";"0";"0";"45080";"46000";"-920"
"2749";"1652722";"2018-03-13";"88403";"2018-03-13";"H-852-17   OTROSI NRO 001";"46000";"45080";"920";"0";"0";"0";"0";"0";"0";"0";"45080";"46000";"-920"
"2750";"1652743";"2018-03-13";"88403";"2018-03-13";"H-852-17   OTROSI NRO 001";"56000";"54880";"1120";"0";"0";"0";"0";"0";"0";"0";"54880";"56000";"-1120"
"2751";"1652747";"2018-03-13";"88403";"2018-03-13";"H-852-17   OTROSI NRO 001";"180000";"176400";"3600";"0";"0";"0";"0";"0";"0";"0";"176400";"180000";"-3600"
"2752";"1652749";"2018-03-13";"88403";"2018-03-13";"H-852-17   OTROSI NRO 001";"56000";"54880";"1120";"0";"0";"0";"0";"0";"0";"0";"54880";"56000";"-1120"
"2753";"1652823";"2018-03-13";"88403";"2018-03-13";"H-852-17   OTROSI NRO 001";"56000";"54880";"1120";"0";"0";"0";"0";"0";"0";"0";"54880";"56000";"-1120"
"2754";"1652829";"2018-03-13";"88403";"2018-03-13";"H-852-17   OTROSI NRO 001";"56000";"54880";"1120";"0";"0";"0";"0";"0";"0";"0";"54880";"56000";"-1120"
"2755";"1652901";"2018-03-13";"88403";"2018-03-13";"H-852-17   OTROSI NRO 001";"56000";"54880";"1120";"0";"0";"0";"0";"0";"0";"0";"54880";"56000";"-1120"
"2756";"1652905";"2018-03-13";"88403";"2018-03-13";"H-852-17   OTROSI NRO 001";"90000";"88200";"1800";"0";"0";"0";"0";"0";"0";"0";"88200";"90000";"-1800"
"2757";"1611963";"2018-03-13";"88460";"2018-03-13";"H-852-17   OTROSI NRO 001";"300149";"294146";"6003";"0";"0";"0";"0";"0";"0";"0";"294146";"300149";"-6003"
"2758";"1620455";"2018-03-13";"88460";"2018-03-13";"H-852-17   OTROSI NRO 001";"56000";"54880";"1120";"0";"0";"0";"0";"0";"0";"0";"54880";"56000";"-1120"
"2759";"1606321";"2018-03-14";"87568";"2018-03-14";"H-852-17   OTROSI NRO 001";"1135350";"1112643";"22707";"0";"0";"0";"318488";"318488";"0";"0";"794155";"816862";"-22707"
"2760";"1606407";"2018-03-14";"87568";"2018-03-14";"H-852-17   OTROSI NRO 001";"1293118";"1267256";"25862";"0";"0";"0";"317188";"317188";"0";"0";"950068";"975930";"-25862"
"2761";"1606411";"2018-03-14";"87568";"2018-03-14";"H-852-17   OTROSI NRO 001";"1331950";"1305311";"26639";"0";"0";"0";"317188";"317188";"0";"0";"988123";"1014762";"-26639"
"2762";"1632450";"2018-03-14";"88287";"2018-03-14";"H-852-17   OTROSI NRO 001";"56000";"54880";"1120";"0";"0";"0";"0";"0";"0";"0";"54880";"56000";"-1120"
"2763";"1648385";"2018-03-14";"88287";"2018-03-14";"H-852-17   OTROSI NRO 001";"311000";"304780";"6220";"0";"0";"0";"0";"0";"0";"0";"304780";"311000";"-6220"
"2764";"1648562";"2018-03-14";"88287";"2018-03-14";"H-852-17   OTROSI NRO 001";"70000";"68600";"1400";"0";"0";"0";"0";"0";"0";"0";"68600";"70000";"-1400"
"2765";"1648577";"2018-03-14";"88287";"2018-03-14";"H-852-17   OTROSI NRO 001";"56000";"54880";"1120";"0";"0";"0";"0";"0";"0";"0";"54880";"56000";"-1120"
"2766";"1648659";"2018-03-14";"88287";"2018-03-14";"H-852-17   OTROSI NRO 001";"46000";"45080";"920";"0";"0";"0";"0";"0";"0";"0";"45080";"46000";"-920"
"2767";"1648784";"2018-03-14";"88287";"2018-03-14";"H-852-17   OTROSI NRO 001";"46000";"45080";"920";"0";"0";"0";"0";"0";"0";"0";"45080";"46000";"-920"
"2768";"1649853";"2018-03-14";"88287";"2018-03-14";"H-852-17   OTROSI NRO 001";"46000";"45080";"920";"0";"0";"0";"0";"0";"0";"0";"45080";"46000";"-920"
"2769";"1649884";"2018-03-14";"88287";"2018-03-14";"H-852-17   OTROSI NRO 001";"46000";"45080";"920";"0";"0";"0";"0";"0";"0";"0";"45080";"46000";"-920"
"2770";"1649891";"2018-03-14";"88287";"2018-03-14";"H-852-17   OTROSI NRO 001";"70000";"68600";"1400";"0";"0";"0";"0";"0";"0";"0";"68600";"70000";"-1400"
"2771";"1650416";"2018-03-14";"88287";"2018-03-14";"H-852-17   OTROSI NRO 001";"56000";"54880";"1120";"0";"0";"0";"0";"0";"0";"0";"54880";"56000";"-1120"
"2772";"1650610";"2018-03-14";"88287";"2018-03-14";"H-852-17   OTROSI NRO 001";"46000";"45080";"920";"0";"0";"0";"0";"0";"0";"0";"45080";"46000";"-920"
"2773";"1651385";"2018-03-14";"88287";"2018-03-14";"H-852-17   OTROSI NRO 001";"46000";"45080";"920";"0";"0";"0";"0";"0";"0";"0";"45080";"46000";"-920"
"2774";"1651391";"2018-03-14";"88287";"2018-03-14";"H-852-17   OTROSI NRO 001";"46000";"45080";"920";"0";"0";"0";"0";"0";"0";"0";"45080";"46000";"-920"
"2775";"1651392";"2018-03-14";"88287";"2018-03-14";"H-852-17   OTROSI NRO 001";"46000";"45080";"920";"0";"0";"0";"0";"0";"0";"0";"45080";"46000";"-920"
"2776";"1651395";"2018-03-14";"88287";"2018-03-14";"H-852-17   OTROSI NRO 001";"46000";"45080";"920";"0";"0";"0";"0";"0";"0";"0";"45080";"46000";"-920"
"2777";"1651416";"2018-03-14";"88287";"2018-03-14";"H-852-17   OTROSI NRO 001";"46000";"45080";"920";"0";"0";"0";"0";"0";"0";"0";"45080";"46000";"-920"
"2778";"1651468";"2018-03-14";"88287";"2018-03-14";"H-852-17   OTROSI NRO 001";"46000";"45080";"920";"0";"0";"0";"0";"0";"0";"0";"45080";"46000";"-920"
"2779";"1651524";"2018-03-14";"88287";"2018-03-14";"H-852-17   OTROSI NRO 001";"46000";"45080";"920";"0";"0";"0";"0";"0";"0";"0";"45080";"46000";"-920"
"2780";"1651535";"2018-03-14";"88287";"2018-03-14";"H-852-17   OTROSI NRO 001";"46000";"45080";"920";"0";"0";"0";"0";"0";"0";"0";"45080";"46000";"-920"
"2781";"1651557";"2018-03-14";"88287";"2018-03-14";"H-852-17   OTROSI NRO 001";"46000";"45080";"920";"0";"0";"0";"0";"0";"0";"0";"45080";"46000";"-920"
"2782";"1651659";"2018-03-14";"88287";"2018-03-14";"H-852-17   OTROSI NRO 001";"46000";"45080";"920";"0";"0";"0";"0";"0";"0";"0";"45080";"46000";"-920"
"2783";"1651736";"2018-03-14";"88287";"2018-03-14";"H-852-17   OTROSI NRO 001";"46000";"45080";"920";"0";"0";"0";"0";"0";"0";"0";"45080";"46000";"-920"
"2784";"1651762";"2018-03-14";"88287";"2018-03-14";"H-852-17   OTROSI NRO 001";"35000";"34300";"700";"0";"0";"0";"0";"0";"0";"0";"34300";"35000";"-700"
"2785";"1651910";"2018-03-14";"88287";"2018-03-14";"H-852-17   OTROSI NRO 001";"40800";"39984";"816";"0";"0";"0";"0";"0";"0";"0";"39984";"40800";"-816"
"2786";"1651918";"2018-03-14";"88287";"2018-03-14";"H-852-17   OTROSI NRO 001";"14594";"14302";"292";"0";"0";"0";"0";"0";"0";"0";"14302";"14594";"-292"
"2787";"1651975";"2018-03-14";"88287";"2018-03-14";"H-852-17   OTROSI NRO 001";"70000";"68600";"1400";"0";"0";"0";"0";"0";"0";"0";"68600";"70000";"-1400"
"2788";"1621989";"2018-03-14";"88589";"2018-03-14";"H-852-17   OTROSI NRO 001";"591350";"579523";"11827";"0";"0";"0";"0";"0";"0";"0";"579523";"591350";"-11827"
"2789";"1627694";"2018-03-16";"87567";"2018-03-16";"H-853-17   OTROSI NRO 001";"227108";"222566";"4542";"0";"0";"0";"0";"0";"0";"0";"222566";"227108";"-4542"
"2790";"1631376";"2018-03-16";"87567";"2018-03-16";"H-853-17   OTROSI NRO 001";"43000";"42140";"860";"0";"0";"0";"0";"0";"0";"0";"42140";"43000";"-860"
"2791";"1631722";"2018-03-16";"87567";"2018-03-16";"H-853-17   OTROSI NRO 001";"56000";"54880";"1120";"0";"0";"0";"0";"0";"0";"0";"54880";"56000";"-1120"
"2792";"1632846";"2018-03-16";"87567";"2018-03-16";"H-853-17   OTROSI NRO 001";"43000";"42140";"860";"0";"0";"0";"0";"0";"0";"0";"42140";"43000";"-860"
"2793";"1633367";"2018-03-16";"87567";"2018-03-16";"H-853-17   OTROSI NRO 001";"15636184";"15323460";"312724";"0";"0";"0";"0";"0";"0";"0";"15323460";"15636184";"-312724"
"2794";"1634080";"2018-03-16";"87567";"2018-03-16";"H-853-17   OTROSI NRO 001";"35000";"34300";"700";"0";"0";"0";"0";"0";"0";"0";"34300";"35000";"-700"
"2795";"1634113";"2018-03-16";"87567";"2018-03-16";"H-853-17   OTROSI NRO 001";"46000";"45080";"920";"0";"0";"0";"0";"0";"0";"0";"45080";"46000";"-920"
"2796";"1636042";"2018-03-16";"87567";"2018-03-16";"H-853-17   OTROSI NRO 001";"46000";"45080";"920";"0";"0";"0";"0";"0";"0";"0";"45080";"46000";"-920"
"2797";"1636518";"2018-03-16";"87567";"2018-03-16";"H-853-17   OTROSI NRO 001";"46000";"45080";"920";"0";"0";"0";"0";"0";"0";"0";"45080";"46000";"-920"
"2798";"1637120";"2018-03-16";"87567";"2018-03-16";"H-853-17   OTROSI NRO 001";"46000";"45080";"920";"0";"0";"0";"0";"0";"0";"0";"45080";"46000";"-920"
"2799";"1637142";"2018-03-16";"87567";"2018-03-16";"H-853-17   OTROSI NRO 001";"41601";"40769";"832";"0";"0";"0";"0";"0";"0";"0";"40769";"41601";"-832"
"2800";"1637149";"2018-03-16";"87567";"2018-03-16";"H-853-17   OTROSI NRO 001";"46000";"45080";"920";"0";"0";"0";"0";"0";"0";"0";"45080";"46000";"-920"
"2801";"1639613";"2018-03-16";"87567";"2018-03-16";"H-853-17   OTROSI NRO 001";"46000";"45080";"920";"0";"0";"0";"0";"0";"0";"0";"45080";"46000";"-920"
"2802";"1639843";"2018-03-16";"87567";"2018-03-16";"H-853-17   OTROSI NRO 001";"53000";"51940";"1060";"0";"0";"0";"0";"0";"0";"0";"51940";"53000";"-1060"
"2803";"1641747";"2018-03-16";"87567";"2018-03-16";"H-853-17   OTROSI NRO 001";"46000";"45080";"920";"0";"0";"0";"0";"0";"0";"0";"45080";"46000";"-920"
"2804";"1642022";"2018-03-16";"87567";"2018-03-16";"H-853-17   OTROSI NRO 001";"46000";"45080";"920";"0";"0";"0";"0";"0";"0";"0";"45080";"46000";"-920"
"2805";"1642566";"2018-03-16";"87567";"2018-03-16";"H-853-17   OTROSI NRO 001";"46000";"45080";"920";"0";"0";"0";"0";"0";"0";"0";"45080";"46000";"-920"
"2806";"1642598";"2018-03-16";"87567";"2018-03-16";"H-853-17   OTROSI NRO 001";"46000";"45080";"920";"0";"0";"0";"0";"0";"0";"0";"45080";"46000";"-920"
"2807";"1643230";"2018-03-16";"87567";"2018-03-16";"H-853-17   OTROSI NRO 001";"67000";"65660";"1340";"0";"0";"0";"0";"0";"0";"0";"65660";"67000";"-1340"
"2808";"1650411";"2018-04-09";"88995";"2018-04-09";"H-852-17   OTROSI NRO 001";"3683512";"3609842";"73670";"0";"0";"0";"41874";"0";"41874";"0";"3609842";"41874";"3567968"
"2809";"1658795";"2018-04-09";"89030";"2018-04-09";"H-852-17   OTROSI NRO 001";"56000";"54880";"1120";"0";"0";"0";"0";"0";"0";"0";"54880";"56000";"-1120"
"2810";"1660802";"2018-04-09";"89030";"2018-04-09";"H-852-17   OTROSI NRO 001";"46000";"45080";"920";"0";"0";"0";"0";"0";"0";"0";"45080";"46000";"-920"
"2811";"1660810";"2018-04-09";"89030";"2018-04-09";"H-852-17   OTROSI NRO 001";"46000";"45080";"920";"0";"0";"0";"0";"0";"0";"0";"45080";"46000";"-920"
"2812";"1660831";"2018-04-09";"89030";"2018-04-09";"H-852-17   OTROSI NRO 001";"46000";"45080";"920";"0";"0";"0";"0";"0";"0";"0";"45080";"46000";"-920"
"2813";"1660838";"2018-04-09";"89030";"2018-04-09";"H-852-17   OTROSI NRO 001";"46000";"45080";"920";"0";"0";"0";"0";"0";"0";"0";"45080";"46000";"-920"
"2814";"1660960";"2018-04-09";"89030";"2018-04-09";"H-852-17   OTROSI NRO 001";"46000";"45080";"920";"0";"0";"0";"0";"0";"0";"0";"45080";"46000";"-920"
"2815";"1660974";"2018-04-09";"89030";"2018-04-09";"H-852-17   OTROSI NRO 001";"46000";"45080";"920";"0";"0";"0";"0";"0";"0";"0";"45080";"46000";"-920"
"2816";"1661012";"2018-04-09";"89030";"2018-04-09";"H-852-17   OTROSI NRO 001";"46000";"45080";"920";"0";"0";"0";"0";"0";"0";"0";"45080";"46000";"-920"
"2817";"1661045";"2018-04-09";"89030";"2018-04-09";"H-852-17   OTROSI NRO 001";"70000";"68600";"1400";"0";"0";"0";"0";"0";"0";"0";"68600";"70000";"-1400"
"2818";"1661297";"2018-04-09";"89030";"2018-04-09";"H-852-17   OTROSI NRO 001";"46000";"45080";"920";"0";"0";"0";"0";"0";"0";"0";"45080";"46000";"-920"
"2819";"1661309";"2018-04-09";"89030";"2018-04-09";"H-852-17   OTROSI NRO 001";"35000";"34300";"700";"0";"0";"0";"0";"0";"0";"0";"34300";"35000";"-700"
"2820";"1661356";"2018-04-09";"89030";"2018-04-09";"H-852-17   OTROSI NRO 001";"56000";"54880";"1120";"0";"0";"0";"0";"0";"0";"0";"54880";"56000";"-1120"
"2821";"1661363";"2018-04-09";"89030";"2018-04-09";"H-852-17   OTROSI NRO 001";"70000";"68600";"1400";"0";"0";"0";"0";"0";"0";"0";"68600";"70000";"-1400"
"2822";"1661392";"2018-04-09";"89030";"2018-04-09";"H-852-17   OTROSI NRO 001";"46000";"45080";"920";"0";"0";"0";"0";"0";"0";"0";"45080";"46000";"-920"
"2823";"1661413";"2018-04-09";"89030";"2018-04-09";"H-852-17   OTROSI NRO 001";"46000";"45080";"920";"0";"0";"0";"0";"0";"0";"0";"45080";"46000";"-920"
"2824";"1661422";"2018-04-09";"89030";"2018-04-09";"H-852-17   OTROSI NRO 001";"46000";"45080";"920";"0";"0";"0";"0";"0";"0";"0";"45080";"46000";"-920"
"2825";"1661452";"2018-04-09";"89030";"2018-04-09";"H-852-17   OTROSI NRO 001";"35000";"34300";"700";"0";"0";"0";"0";"0";"0";"0";"34300";"35000";"-700"
"2826";"1661470";"2018-04-09";"89030";"2018-04-09";"H-852-17   OTROSI NRO 001";"46000";"45080";"920";"0";"0";"0";"0";"0";"0";"0";"45080";"46000";"-920"
"2827";"1661494";"2018-04-09";"89030";"2018-04-09";"H-852-17   OTROSI NRO 001";"35000";"34300";"700";"0";"0";"0";"0";"0";"0";"0";"34300";"35000";"-700"
"2828";"1661497";"2018-04-09";"89030";"2018-04-09";"H-852-17   OTROSI NRO 001";"46000";"45080";"920";"0";"0";"0";"0";"0";"0";"0";"45080";"46000";"-920"
"2829";"1661502";"2018-04-09";"89030";"2018-04-09";"H-852-17   OTROSI NRO 001";"46000";"45080";"920";"0";"0";"0";"0";"0";"0";"0";"45080";"46000";"-920"
"2830";"1661510";"2018-04-09";"89030";"2018-04-09";"H-852-17   OTROSI NRO 001";"46000";"45080";"920";"0";"0";"0";"0";"0";"0";"0";"45080";"46000";"-920"
"2831";"1661519";"2018-04-09";"89030";"2018-04-09";"H-852-17   OTROSI NRO 001";"180000";"176400";"3600";"0";"0";"0";"0";"0";"0";"0";"176400";"180000";"-3600"
"2832";"1661577";"2018-04-09";"89030";"2018-04-09";"H-852-17   OTROSI NRO 001";"90000";"88200";"1800";"0";"0";"0";"0";"0";"0";"0";"88200";"90000";"-1800"
"2833";"1661613";"2018-04-09";"89030";"2018-04-09";"H-852-17   OTROSI NRO 001";"46000";"45080";"920";"0";"0";"0";"0";"0";"0";"0";"45080";"46000";"-920"
"2834";"1661762";"2018-04-09";"89030";"2018-04-09";"H-852-17   OTROSI NRO 001";"279000";"273420";"5580";"0";"0";"0";"0";"0";"0";"0";"273420";"279000";"-5580"
"2835";"1661807";"2018-04-09";"89030";"2018-04-09";"H-852-17   OTROSI NRO 001";"46000";"45080";"920";"0";"0";"0";"0";"0";"0";"0";"45080";"46000";"-920"
"2836";"1661843";"2018-04-09";"89030";"2018-04-09";"H-852-17   OTROSI NRO 001";"56000";"54880";"1120";"0";"0";"0";"0";"0";"0";"0";"54880";"56000";"-1120"
"2837";"1662358";"2018-04-09";"89030";"2018-04-09";"H-852-17   OTROSI NRO 001";"46000";"45080";"920";"0";"0";"0";"0";"0";"0";"0";"45080";"46000";"-920"
"2838";"1662387";"2018-04-09";"89030";"2018-04-09";"H-852-17   OTROSI NRO 001";"35000";"34300";"700";"0";"0";"0";"0";"0";"0";"0";"34300";"35000";"-700"
"2839";"1662771";"2018-04-09";"89030";"2018-04-09";"H-852-17   OTROSI NRO 001";"21845";"21408";"437";"0";"0";"0";"0";"0";"0";"0";"21408";"21845";"-437"
"2840";"1662800";"2018-04-09";"89030";"2018-04-09";"H-852-17   OTROSI NRO 001";"70000";"68600";"1400";"0";"0";"0";"0";"0";"0";"0";"68600";"70000";"-1400"
"2841";"1662802";"2018-04-09";"89030";"2018-04-09";"H-852-17   OTROSI NRO 001";"46000";"45080";"920";"0";"0";"0";"0";"0";"0";"0";"45080";"46000";"-920"
"2842";"1662829";"2018-04-09";"89030";"2018-04-09";"H-852-17   OTROSI NRO 001";"46000";"45080";"920";"0";"0";"0";"0";"0";"0";"0";"45080";"46000";"-920"
"2843";"1662834";"2018-04-09";"89030";"2018-04-09";"H-852-17   OTROSI NRO 001";"70000";"68600";"1400";"0";"0";"0";"0";"0";"0";"0";"68600";"70000";"-1400"
"2844";"1654056";"2018-04-09";"89267";"2018-04-09";"H-852-17   OTROSI NRO 001";"274200";"268716";"5484";"0";"0";"0";"0";"0";"0";"0";"268716";"274200";"-5484"
"2845";"1656605";"2018-04-09";"89267";"2018-04-09";"H-852-17   OTROSI NRO 001";"1537656";"1506903";"30753";"0";"0";"0";"0";"0";"0";"0";"1506903";"1537656";"-30753"
"2846";"1657418";"2018-04-09";"89267";"2018-04-09";"H-852-17   OTROSI NRO 001";"207100";"225498";"-18398";"0";"0";"0";"0";"0";"0";"0";"225498";"207100";"18398"
"2847";"1658310";"2018-04-09";"89267";"2018-04-09";"H-852-17   OTROSI NRO 001";"775448";"759939";"15509";"0";"0";"0";"0";"0";"0";"0";"759939";"775448";"-15509"
"2848";"1659032";"2018-04-09";"89267";"2018-04-09";"H-852-17   OTROSI NRO 001";"56000";"54880";"1120";"0";"0";"0";"0";"0";"0";"0";"54880";"56000";"-1120"
"2849";"1659893";"2018-04-09";"89267";"2018-04-09";"H-852-17   OTROSI NRO 001";"862650";"845397";"17253";"0";"0";"0";"0";"0";"0";"0";"845397";"862650";"-17253"
"2850";"1659928";"2018-04-09";"89267";"2018-04-09";"H-852-17   OTROSI NRO 001";"300149";"294146";"6003";"0";"0";"0";"0";"0";"0";"0";"294146";"300149";"-6003"
"2851";"1659953";"2018-04-09";"89267";"2018-04-09";"H-852-17   OTROSI NRO 001";"770008";"754608";"15400";"0";"0";"0";"0";"0";"0";"0";"754608";"770008";"-15400"
"2852";"1660031";"2018-04-09";"89267";"2018-04-09";"H-852-17   OTROSI NRO 001";"450849";"441832";"9017";"0";"0";"0";"0";"0";"0";"0";"441832";"450849";"-9017"
"2853";"1660092";"2018-04-09";"89267";"2018-04-09";"H-852-17   OTROSI NRO 001";"1110259";"1088054";"22205";"0";"0";"0";"0";"0";"0";"0";"1088054";"1110259";"-22205"
"2854";"1660338";"2018-04-09";"89267";"2018-04-09";"H-852-17   OTROSI NRO 001";"548400";"537432";"10968";"0";"0";"0";"0";"0";"0";"0";"537432";"548400";"-10968"
"2855";"1660652";"2018-04-09";"89267";"2018-04-09";"H-852-17   OTROSI NRO 001";"450000";"490000";"-40000";"0";"0";"0";"0";"0";"0";"0";"490000";"450000";"40000"
"2856";"1660821";"2018-04-09";"89267";"2018-04-09";"H-852-17   OTROSI NRO 001";"40800";"39984";"816";"0";"0";"0";"0";"0";"0";"0";"39984";"40800";"-816"
"2857";"1661980";"2018-04-09";"89267";"2018-04-09";"H-852-17   OTROSI NRO 001";"274200";"268716";"5484";"0";"0";"0";"0";"0";"0";"0";"268716";"274200";"-5484"
"2858";"1662307";"2018-04-09";"89267";"2018-04-09";"H-852-17   OTROSI NRO 001";"61700";"60466";"1234";"0";"0";"0";"0";"0";"0";"0";"60466";"61700";"-1234"
"2859";"1662313";"2018-04-09";"89267";"2018-04-09";"H-852-17   OTROSI NRO 001";"14594";"14302";"292";"0";"0";"0";"0";"0";"0";"0";"14302";"14594";"-292"
"2860";"1662316";"2018-04-09";"89267";"2018-04-09";"H-852-17   OTROSI NRO 001";"27400";"26852";"548";"0";"0";"0";"0";"0";"0";"0";"26852";"27400";"-548"
"2861";"1662509";"2018-04-09";"89267";"2018-04-09";"H-852-17   OTROSI NRO 001";"400000";"392000";"8000";"0";"0";"0";"0";"0";"0";"0";"392000";"400000";"-8000"
"2862";"1663561";"2018-04-09";"89267";"2018-04-09";"H-852-17   OTROSI NRO 001";"274200";"268716";"5484";"0";"0";"0";"0";"0";"0";"0";"268716";"274200";"-5484"
"2863";"1664058";"2018-04-09";"89267";"2018-04-09";"H-852-17   OTROSI NRO 001";"274200";"268716";"5484";"0";"0";"0";"0";"0";"0";"0";"268716";"274200";"-5484"
"2864";"1664813";"2018-04-09";"89267";"2018-04-09";"H-852-17   OTROSI NRO 001";"56000";"54880";"1120";"0";"0";"0";"0";"0";"0";"0";"54880";"56000";"-1120"
"2865";"1664958";"2018-04-09";"89267";"2018-04-09";"H-852-17   OTROSI NRO 001";"38364";"37597";"767";"0";"0";"0";"0";"0";"0";"0";"37597";"38364";"-767"
"2866";"1665268";"2018-04-09";"89267";"2018-04-09";"H-852-17   OTROSI NRO 001";"46000";"45080";"920";"0";"0";"0";"0";"0";"0";"0";"45080";"46000";"-920"
"2867";"1665305";"2018-04-09";"89267";"2018-04-09";"H-852-17   OTROSI NRO 001";"46000";"45080";"920";"0";"0";"0";"0";"0";"0";"0";"45080";"46000";"-920"
"2868";"1665316";"2018-04-09";"89267";"2018-04-09";"H-852-17   OTROSI NRO 001";"410690";"402476";"8214";"0";"0";"0";"0";"0";"0";"0";"402476";"410690";"-8214"
"2869";"1665390";"2018-04-09";"89267";"2018-04-09";"H-852-17   OTROSI NRO 001";"46000";"45080";"920";"0";"0";"0";"0";"0";"0";"0";"45080";"46000";"-920"
"2870";"1665407";"2018-04-09";"89267";"2018-04-09";"H-852-17   OTROSI NRO 001";"46000";"45080";"920";"0";"0";"0";"0";"0";"0";"0";"45080";"46000";"-920"
"2871";"1665594";"2018-04-09";"89267";"2018-04-09";"H-852-17   OTROSI NRO 001";"70000";"68600";"1400";"0";"0";"0";"0";"0";"0";"0";"68600";"70000";"-1400"
"2872";"1665640";"2018-04-09";"89267";"2018-04-09";"H-852-17   OTROSI NRO 001";"70000";"68600";"1400";"0";"0";"0";"0";"0";"0";"0";"68600";"70000";"-1400"
"2873";"1665646";"2018-04-09";"89267";"2018-04-09";"H-852-17   OTROSI NRO 001";"46000";"45080";"920";"0";"0";"0";"0";"0";"0";"0";"45080";"46000";"-920"
"2874";"1665752";"2018-04-09";"89267";"2018-04-09";"H-852-17   OTROSI NRO 001";"56000";"54880";"1120";"0";"0";"0";"0";"0";"0";"0";"54880";"56000";"-1120"
"2875";"1665785";"2018-04-09";"89267";"2018-04-09";"H-852-17   OTROSI NRO 001";"70000";"68600";"1400";"0";"0";"0";"0";"0";"0";"0";"68600";"70000";"-1400"
"2876";"1665786";"2018-04-09";"89267";"2018-04-09";"H-852-17   OTROSI NRO 001";"14594";"14302";"292";"0";"0";"0";"0";"0";"0";"0";"14302";"14594";"-292"
"2877";"1665809";"2018-04-09";"89267";"2018-04-09";"H-852-17   OTROSI NRO 001";"61700";"60466";"1234";"0";"0";"0";"0";"0";"0";"0";"60466";"61700";"-1234"
"2878";"1665873";"2018-04-09";"89267";"2018-04-09";"H-852-17   OTROSI NRO 001";"56000";"54880";"1120";"0";"0";"0";"0";"0";"0";"0";"54880";"56000";"-1120"
"2879";"1652398";"2018-04-09";"88913";"2018-04-09";"H-852-17   OTROSI NRO 001";"56000";"54880";"1120";"0";"0";"0";"0";"0";"0";"0";"54880";"56000";"-1120"
"2880";"1652400";"2018-04-09";"88913";"2018-04-09";"H-852-17   OTROSI NRO 001";"56000";"54880";"1120";"0";"0";"0";"0";"0";"0";"0";"54880";"56000";"-1120"
"2881";"1652611";"2018-04-09";"88913";"2018-04-09";"H-852-17   OTROSI NRO 001";"56000";"54880";"1120";"0";"0";"0";"0";"0";"0";"0";"54880";"56000";"-1120"
"2882";"1652968";"2018-04-09";"88913";"2018-04-09";"H-852-17   OTROSI NRO 001";"56000";"54880";"1120";"0";"0";"0";"0";"0";"0";"0";"54880";"56000";"-1120"
"2883";"1653028";"2018-04-09";"88913";"2018-04-09";"H-852-17   OTROSI NRO 001";"46000";"45080";"920";"0";"0";"0";"0";"0";"0";"0";"45080";"46000";"-920"
"2884";"1653037";"2018-04-09";"88913";"2018-04-09";"H-852-17   OTROSI NRO 001";"46000";"45080";"920";"0";"0";"0";"0";"0";"0";"0";"45080";"46000";"-920"
"2885";"1653039";"2018-04-09";"88913";"2018-04-09";"H-852-17   OTROSI NRO 001";"46000";"45080";"920";"0";"0";"0";"0";"0";"0";"0";"45080";"46000";"-920"
"2886";"1653040";"2018-04-09";"88913";"2018-04-09";"H-852-17   OTROSI NRO 001";"46000";"45080";"920";"0";"0";"0";"0";"0";"0";"0";"45080";"46000";"-920"
"2887";"1653162";"2018-04-09";"88913";"2018-04-09";"H-852-17   OTROSI NRO 001";"46000";"45080";"920";"0";"0";"0";"0";"0";"0";"0";"45080";"46000";"-920"
"2888";"1653287";"2018-04-09";"88913";"2018-04-09";"H-852-17   OTROSI NRO 001";"46000";"45080";"920";"0";"0";"0";"0";"0";"0";"0";"45080";"46000";"-920"
"2889";"1653309";"2018-04-09";"88913";"2018-04-09";"H-852-17   OTROSI NRO 001";"90000";"88200";"1800";"0";"0";"0";"0";"0";"0";"0";"88200";"90000";"-1800"
"2890";"1653326";"2018-04-09";"88913";"2018-04-09";"H-852-17   OTROSI NRO 001";"46000";"45080";"920";"0";"0";"0";"0";"0";"0";"0";"45080";"46000";"-920"
"2891";"1653341";"2018-04-09";"88913";"2018-04-09";"H-852-17   OTROSI NRO 001";"180000";"176400";"3600";"0";"0";"0";"0";"0";"0";"0";"176400";"180000";"-3600"
"2892";"1653357";"2018-04-09";"88913";"2018-04-09";"H-852-17   OTROSI NRO 001";"46000";"45080";"920";"0";"0";"0";"0";"0";"0";"0";"45080";"46000";"-920"
"2893";"1653382";"2018-04-09";"88913";"2018-04-09";"H-852-17   OTROSI NRO 001";"46000";"45080";"920";"0";"0";"0";"0";"0";"0";"0";"45080";"46000";"-920"
"2894";"1653418";"2018-04-09";"88913";"2018-04-09";"H-852-17   OTROSI NRO 001";"46000";"45080";"920";"0";"0";"0";"0";"0";"0";"0";"45080";"46000";"-920"
"2895";"1653455";"2018-04-09";"88913";"2018-04-09";"H-852-17   OTROSI NRO 001";"56000";"54880";"1120";"0";"0";"0";"0";"0";"0";"0";"54880";"56000";"-1120"
"2896";"1653471";"2018-04-09";"88913";"2018-04-09";"H-852-17   OTROSI NRO 001";"46000";"45080";"920";"0";"0";"0";"0";"0";"0";"0";"45080";"46000";"-920"
"2897";"1653474";"2018-04-09";"88913";"2018-04-09";"H-852-17   OTROSI NRO 001";"46000";"45080";"920";"0";"0";"0";"0";"0";"0";"0";"45080";"46000";"-920"
"2898";"1653631";"2018-04-09";"88913";"2018-04-09";"H-852-17   OTROSI NRO 001";"180000";"176400";"3600";"0";"0";"0";"0";"0";"0";"0";"176400";"180000";"-3600"
"2899";"1653639";"2018-04-09";"88913";"2018-04-09";"H-852-17   OTROSI NRO 001";"35000";"34300";"700";"0";"0";"0";"0";"0";"0";"0";"34300";"35000";"-700"
"2900";"1653649";"2018-04-09";"88913";"2018-04-09";"H-852-17   OTROSI NRO 001";"46000";"45080";"920";"0";"0";"0";"0";"0";"0";"0";"45080";"46000";"-920"
"2901";"1653650";"2018-04-09";"88913";"2018-04-09";"H-852-17   OTROSI NRO 001";"35900";"35182";"718";"0";"0";"0";"0";"0";"0";"0";"35182";"35900";"-718"
"2902";"1653660";"2018-04-09";"88913";"2018-04-09";"H-852-17   OTROSI NRO 001";"35000";"34300";"700";"0";"0";"0";"0";"0";"0";"0";"34300";"35000";"-700"
"2903";"1653679";"2018-04-09";"88913";"2018-04-09";"H-852-17   OTROSI NRO 001";"56000";"54880";"1120";"0";"0";"0";"0";"0";"0";"0";"54880";"56000";"-1120"
"2904";"1653897";"2018-04-09";"88913";"2018-04-09";"H-852-17   OTROSI NRO 001";"70000";"68600";"1400";"0";"0";"0";"0";"0";"0";"0";"68600";"70000";"-1400"
"2905";"1653964";"2018-04-09";"88913";"2018-04-09";"H-852-17   OTROSI NRO 001";"56000";"54880";"1120";"0";"0";"0";"0";"0";"0";"0";"54880";"56000";"-1120"
"2906";"1654036";"2018-04-09";"88913";"2018-04-09";"H-852-17   OTROSI NRO 001";"56000";"54880";"1120";"0";"0";"0";"0";"0";"0";"0";"54880";"56000";"-1120"
"2907";"1654096";"2018-04-09";"88913";"2018-04-09";"H-852-17   OTROSI NRO 001";"46000";"45080";"920";"0";"0";"0";"0";"0";"0";"0";"45080";"46000";"-920"
"2908";"1654098";"2018-04-09";"88913";"2018-04-09";"H-852-17   OTROSI NRO 001";"46000";"45080";"920";"0";"0";"0";"0";"0";"0";"0";"45080";"46000";"-920"
"2909";"1654100";"2018-04-09";"88913";"2018-04-09";"H-852-17   OTROSI NRO 001";"56000";"54880";"1120";"0";"0";"0";"0";"0";"0";"0";"54880";"56000";"-1120"
"2910";"1654129";"2018-04-09";"88913";"2018-04-09";"H-852-17   OTROSI NRO 001";"46000";"45080";"920";"0";"0";"0";"0";"0";"0";"0";"45080";"46000";"-920"
"2911";"1654158";"2018-04-09";"88913";"2018-04-09";"H-852-17   OTROSI NRO 001";"46000";"45080";"920";"0";"0";"0";"0";"0";"0";"0";"45080";"46000";"-920"
"2912";"1654172";"2018-04-09";"88913";"2018-04-09";"H-852-17   OTROSI NRO 001";"56000";"54880";"1120";"0";"0";"0";"0";"0";"0";"0";"54880";"56000";"-1120"
"2913";"1654248";"2018-04-09";"88913";"2018-04-09";"H-852-17   OTROSI NRO 001";"46000";"45080";"920";"0";"0";"0";"0";"0";"0";"0";"45080";"46000";"-920"
"2914";"1655996";"2018-04-09";"89251";"2018-04-09";"H-852-17   OTROSI NRO 001";"453899";"444821";"9078";"0";"0";"0";"0";"0";"0";"0";"444821";"453899";"-9078"
"2915";"1656003";"2018-04-09";"89251";"2018-04-09";"H-852-17   OTROSI NRO 001";"450449";"441440";"9009";"0";"0";"0";"0";"0";"0";"0";"441440";"450449";"-9009"
"2916";"1665269";"2018-04-09";"89251";"2018-04-09";"H-852-17   OTROSI NRO 001";"46000";"45080";"920";"0";"0";"0";"0";"0";"0";"0";"45080";"46000";"-920"
"2917";"1665285";"2018-04-09";"89251";"2018-04-09";"H-852-17   OTROSI NRO 001";"56000";"54880";"1120";"0";"0";"0";"0";"0";"0";"0";"54880";"56000";"-1120"
"2918";"1665473";"2018-04-09";"89251";"2018-04-09";"H-852-17   OTROSI NRO 001";"46000";"45080";"920";"0";"0";"0";"0";"0";"0";"0";"45080";"46000";"-920"
"2919";"1665517";"2018-04-09";"89251";"2018-04-09";"H-852-17   OTROSI NRO 001";"46000";"45080";"920";"0";"0";"0";"0";"0";"0";"0";"45080";"46000";"-920"
"2920";"1665521";"2018-04-09";"89251";"2018-04-09";"H-852-17   OTROSI NRO 001";"46000";"45080";"920";"0";"0";"0";"0";"0";"0";"0";"45080";"46000";"-920"
"2921";"1665527";"2018-04-09";"89251";"2018-04-09";"H-852-17   OTROSI NRO 001";"56000";"54880";"1120";"0";"0";"0";"0";"0";"0";"0";"54880";"56000";"-1120"
"2922";"1665552";"2018-04-09";"89251";"2018-04-09";"H-852-17   OTROSI NRO 001";"46000";"45080";"920";"0";"0";"0";"0";"0";"0";"0";"45080";"46000";"-920"
"2923";"1665576";"2018-04-09";"89251";"2018-04-09";"H-852-17   OTROSI NRO 001";"70000";"68600";"1400";"0";"0";"0";"0";"0";"0";"0";"68600";"70000";"-1400"
"2924";"1665704";"2018-04-09";"89251";"2018-04-09";"H-852-17   OTROSI NRO 001";"792056";"776215";"15841";"0";"0";"0";"223000";"111500";"111500";"0";"664715";"569056";"95659"
"2925";"1665826";"2018-04-09";"89251";"2018-04-09";"H-852-17   OTROSI NRO 001";"56000";"54880";"1120";"0";"0";"0";"0";"0";"0";"0";"54880";"56000";"-1120"
"2926";"1666174";"2018-04-09";"89251";"2018-04-09";"H-852-17   OTROSI NRO 001";"35000";"34300";"700";"0";"0";"0";"0";"0";"0";"0";"34300";"35000";"-700"
"2927";"1666196";"2018-04-09";"89251";"2018-04-09";"H-852-17   OTROSI NRO 001";"46000";"45080";"920";"0";"0";"0";"0";"0";"0";"0";"45080";"46000";"-920"
"2928";"1666278";"2018-04-09";"89251";"2018-04-09";"H-852-17   OTROSI NRO 001";"35000";"34300";"700";"0";"0";"0";"0";"0";"0";"0";"34300";"35000";"-700"
"2929";"1666287";"2018-04-09";"89251";"2018-04-09";"H-852-17   OTROSI NRO 001";"35000";"34300";"700";"0";"0";"0";"0";"0";"0";"0";"34300";"35000";"-700"
"2930";"1666338";"2018-04-09";"89251";"2018-04-09";"H-852-17   OTROSI NRO 001";"27700";"27146";"554";"0";"0";"0";"0";"0";"0";"0";"27146";"27700";"-554"
"2931";"1666373";"2018-04-09";"89251";"2018-04-09";"H-852-17   OTROSI NRO 001";"35000";"34300";"700";"0";"0";"0";"0";"0";"0";"0";"34300";"35000";"-700"
"2932";"1666422";"2018-04-09";"89251";"2018-04-09";"H-852-17   OTROSI NRO 001";"46000";"45080";"920";"0";"0";"0";"0";"0";"0";"0";"45080";"46000";"-920"
"2933";"1666449";"2018-04-09";"89251";"2018-04-09";"H-852-17   OTROSI NRO 001";"274200";"268716";"5484";"0";"0";"0";"0";"0";"0";"0";"268716";"274200";"-5484"
"2934";"1666496";"2018-04-09";"89251";"2018-04-09";"H-852-17   OTROSI NRO 001";"46000";"45080";"920";"0";"0";"0";"0";"0";"0";"0";"45080";"46000";"-920"
"2935";"1666561";"2018-04-09";"89251";"2018-04-09";"H-852-17   OTROSI NRO 001";"46000";"45080";"920";"0";"0";"0";"0";"0";"0";"0";"45080";"46000";"-920"
"2936";"1666568";"2018-04-09";"89251";"2018-04-09";"H-852-17   OTROSI NRO 001";"46000";"45080";"920";"0";"0";"0";"0";"0";"0";"0";"45080";"46000";"-920"
"2937";"1666570";"2018-04-09";"89251";"2018-04-09";"H-852-17   OTROSI NRO 001";"70000";"68600";"1400";"0";"0";"0";"0";"0";"0";"0";"68600";"70000";"-1400"
"2938";"1666669";"2018-04-09";"89251";"2018-04-09";"H-852-17   OTROSI NRO 001";"46000";"45080";"920";"0";"0";"0";"0";"0";"0";"0";"45080";"46000";"-920"
"2939";"1666758";"2018-04-09";"89251";"2018-04-09";"H-852-17   OTROSI NRO 001";"46000";"45080";"920";"0";"0";"0";"0";"0";"0";"0";"45080";"46000";"-920"
"2940";"1649189";"2018-04-09";"88911";"2018-04-09";"H-852-17   OTROSI NRO 001";"311000";"304780";"6220";"0";"0";"0";"0";"0";"0";"0";"304780";"311000";"-6220"
"2941";"1652642";"2018-04-09";"88911";"2018-04-09";"H-852-17   OTROSI NRO 001";"56000";"54880";"1120";"0";"0";"0";"0";"0";"0";"0";"54880";"56000";"-1120"
"2942";"1653113";"2018-04-09";"88911";"2018-04-09";"H-852-17   OTROSI NRO 001";"46000";"45080";"920";"0";"0";"0";"0";"0";"0";"0";"45080";"46000";"-920"
"2943";"1653920";"2018-04-09";"88911";"2018-04-09";"H-852-17   OTROSI NRO 001";"46000";"45080";"920";"0";"0";"0";"0";"0";"0";"0";"45080";"46000";"-920"
"2944";"1653921";"2018-04-09";"88911";"2018-04-09";"H-852-17   OTROSI NRO 001";"56000";"54880";"1120";"0";"0";"0";"0";"0";"0";"0";"54880";"56000";"-1120"
"2945";"1656250";"2018-04-09";"88911";"2018-04-09";"H-852-17   OTROSI NRO 001";"46000";"45080";"920";"0";"0";"0";"0";"0";"0";"0";"45080";"46000";"-920"
"2946";"1656279";"2018-04-09";"88911";"2018-04-09";"H-852-17   OTROSI NRO 001";"46000";"45080";"920";"0";"0";"0";"0";"0";"0";"0";"45080";"46000";"-920"
"2947";"1656312";"2018-04-09";"88911";"2018-04-09";"H-852-17   OTROSI NRO 001";"46000";"45080";"920";"0";"0";"0";"0";"0";"0";"0";"45080";"46000";"-920"
"2948";"1656318";"2018-04-09";"88911";"2018-04-09";"H-852-17   OTROSI NRO 001";"70000";"68600";"1400";"0";"0";"0";"0";"0";"0";"0";"68600";"70000";"-1400"
"2949";"1656360";"2018-04-09";"88911";"2018-04-09";"H-852-17   OTROSI NRO 001";"35000";"34300";"700";"0";"0";"0";"0";"0";"0";"0";"34300";"35000";"-700"
"2950";"1656369";"2018-04-09";"88911";"2018-04-09";"H-852-17   OTROSI NRO 001";"46000";"45080";"920";"0";"0";"0";"0";"0";"0";"0";"45080";"46000";"-920"
"2951";"1656384";"2018-04-09";"88911";"2018-04-09";"H-852-17   OTROSI NRO 001";"56000";"54880";"1120";"0";"0";"0";"0";"0";"0";"0";"54880";"56000";"-1120"
"2952";"1656416";"2018-04-09";"88911";"2018-04-09";"H-852-17   OTROSI NRO 001";"56000";"54880";"1120";"0";"0";"0";"0";"0";"0";"0";"54880";"56000";"-1120"
"2953";"1656417";"2018-04-09";"88911";"2018-04-09";"H-852-17   OTROSI NRO 001";"70000";"68600";"1400";"0";"0";"0";"0";"0";"0";"0";"68600";"70000";"-1400"
"2954";"1656429";"2018-04-09";"88911";"2018-04-09";"H-852-17   OTROSI NRO 001";"35000";"34300";"700";"0";"0";"0";"0";"0";"0";"0";"34300";"35000";"-700"
"2955";"1656475";"2018-04-09";"88911";"2018-04-09";"H-852-17   OTROSI NRO 001";"46000";"45080";"920";"0";"0";"0";"0";"0";"0";"0";"45080";"46000";"-920"
"2956";"1656502";"2018-04-09";"88911";"2018-04-09";"H-852-17   OTROSI NRO 001";"46000";"45080";"920";"0";"0";"0";"0";"0";"0";"0";"45080";"46000";"-920"
"2957";"1656543";"2018-04-09";"88911";"2018-04-09";"H-852-17   OTROSI NRO 001";"46000";"45080";"920";"0";"0";"0";"0";"0";"0";"0";"45080";"46000";"-920"
"2958";"1656599";"2018-04-09";"88911";"2018-04-09";"H-852-17   OTROSI NRO 001";"46000";"45080";"920";"0";"0";"0";"0";"0";"0";"0";"45080";"46000";"-920"
"2959";"1656677";"2018-04-09";"88911";"2018-04-09";"H-852-17   OTROSI NRO 001";"180000";"176400";"3600";"0";"0";"0";"0";"0";"0";"0";"176400";"180000";"-3600"
"2960";"1656878";"2018-04-09";"88911";"2018-04-09";"H-852-17   OTROSI NRO 001";"46000";"45080";"920";"0";"0";"0";"0";"0";"0";"0";"45080";"46000";"-920"
"2961";"1656927";"2018-04-09";"88911";"2018-04-09";"H-852-17   OTROSI NRO 001";"56000";"54880";"1120";"0";"0";"0";"0";"0";"0";"0";"54880";"56000";"-1120"
"2962";"1656937";"2018-04-09";"88911";"2018-04-09";"H-852-17   OTROSI NRO 001";"35000";"34300";"700";"0";"0";"0";"0";"0";"0";"0";"34300";"35000";"-700"
"2963";"1656973";"2018-04-09";"88911";"2018-04-09";"H-852-17   OTROSI NRO 001";"46000";"45080";"920";"0";"0";"0";"0";"0";"0";"0";"45080";"46000";"-920"
"2964";"1656978";"2018-04-09";"88911";"2018-04-09";"H-852-17   OTROSI NRO 001";"70000";"68600";"1400";"0";"0";"0";"0";"0";"0";"0";"68600";"70000";"-1400"
"2965";"1657001";"2018-04-09";"88911";"2018-04-09";"H-852-17   OTROSI NRO 001";"70000";"68600";"1400";"0";"0";"0";"0";"0";"0";"0";"68600";"70000";"-1400"
"2966";"1657030";"2018-04-09";"88911";"2018-04-09";"H-852-17   OTROSI NRO 001";"56000";"54880";"1120";"0";"0";"0";"0";"0";"0";"0";"54880";"56000";"-1120"
"2967";"1657033";"2018-04-09";"88911";"2018-04-09";"H-852-17   OTROSI NRO 001";"70000";"68600";"1400";"0";"0";"0";"0";"0";"0";"0";"68600";"70000";"-1400"
"2968";"1658398";"2018-04-09";"88911";"2018-04-09";"H-852-17   OTROSI NRO 001";"180000";"176400";"3600";"0";"0";"0";"0";"0";"0";"0";"176400";"180000";"-3600"
"2969";"1658596";"2018-04-09";"88911";"2018-04-09";"H-852-17   OTROSI NRO 001";"56000";"54880";"1120";"0";"0";"0";"0";"0";"0";"0";"54880";"56000";"-1120"
"2970";"1658599";"2018-04-09";"88911";"2018-04-09";"H-852-17   OTROSI NRO 001";"46000";"45080";"920";"0";"0";"0";"0";"0";"0";"0";"45080";"46000";"-920"
"2971";"1659998";"2018-04-09";"88911";"2018-04-09";"H-852-17   OTROSI NRO 001";"35000";"34300";"700";"0";"0";"0";"0";"0";"0";"0";"34300";"35000";"-700"
"2972";"1660017";"2018-04-09";"88911";"2018-04-09";"H-852-17   OTROSI NRO 001";"300149";"294146";"6003";"0";"0";"0";"0";"0";"0";"0";"294146";"300149";"-6003"
"2973";"1663393";"2018-04-09";"89318";"2018-04-09";"H-852-17   OTROSI NRO 001";"99094";"97112";"1982";"0";"0";"0";"0";"0";"0";"0";"97112";"99094";"-1982"
"2974";"1665272";"2018-04-09";"89318";"2018-04-09";"H-852-17   OTROSI NRO 001";"274200";"268716";"5484";"0";"0";"0";"0";"0";"0";"0";"268716";"274200";"-5484"
"2975";"1666288";"2018-04-09";"89318";"2018-04-09";"H-852-17   OTROSI NRO 001";"174090";"170608";"3482";"0";"0";"0";"0";"0";"0";"0";"170608";"174090";"-3482"
"2976";"1666360";"2018-04-09";"89318";"2018-04-09";"H-852-17   OTROSI NRO 001";"147500";"144550";"2950";"0";"0";"0";"0";"0";"0";"0";"144550";"147500";"-2950"
"2977";"1666362";"2018-04-09";"89318";"2018-04-09";"H-852-17   OTROSI NRO 001";"35000";"34300";"700";"0";"0";"0";"0";"0";"0";"0";"34300";"35000";"-700"
"2978";"1666814";"2018-04-09";"89318";"2018-04-09";"H-852-17   OTROSI NRO 001";"27571";"27020";"551";"0";"0";"0";"0";"0";"0";"0";"27020";"27571";"-551"
"2979";"1667266";"2018-04-09";"89318";"2018-04-09";"H-852-17   OTROSI NRO 001";"46000";"45080";"920";"0";"0";"0";"0";"0";"0";"0";"45080";"46000";"-920"
"2980";"1667327";"2018-04-09";"89318";"2018-04-09";"H-852-17   OTROSI NRO 001";"46000";"45080";"920";"0";"0";"0";"0";"0";"0";"0";"45080";"46000";"-920"
"2981";"1667370";"2018-04-09";"89318";"2018-04-09";"H-852-17   OTROSI NRO 001";"548400";"537432";"10968";"0";"0";"0";"0";"0";"0";"0";"537432";"548400";"-10968"
"2982";"1667401";"2018-04-09";"89318";"2018-04-09";"H-852-17   OTROSI NRO 001";"70000";"68600";"1400";"0";"0";"0";"0";"0";"0";"0";"68600";"70000";"-1400"
"2983";"1667416";"2018-04-09";"89318";"2018-04-09";"H-852-17   OTROSI NRO 001";"274200";"268716";"5484";"0";"0";"0";"0";"0";"0";"0";"268716";"274200";"-5484"
"2984";"1667731";"2018-04-09";"89318";"2018-04-09";"H-852-17   OTROSI NRO 001";"70000";"68600";"1400";"0";"0";"0";"0";"0";"0";"0";"68600";"70000";"-1400"
"2985";"1667823";"2018-04-09";"89318";"2018-04-09";"H-852-17   OTROSI NRO 001";"46000";"45080";"920";"0";"0";"0";"0";"0";"0";"0";"45080";"46000";"-920"
"2986";"1667849";"2018-04-09";"89318";"2018-04-09";"H-852-17   OTROSI NRO 001";"35000";"34300";"700";"0";"0";"0";"0";"0";"0";"0";"34300";"35000";"-700"
"2987";"1667886";"2018-04-09";"89318";"2018-04-09";"H-852-17   OTROSI NRO 001";"249890";"244892";"4998";"0";"0";"0";"0";"0";"0";"0";"244892";"249890";"-4998"
"2988";"1659650";"2018-04-09";"89348";"2018-04-09";"H-852-17   OTROSI NRO 001";"2652668";"2599615";"53053";"0";"0";"0";"0";"0";"0";"0";"2599615";"2652668";"-53053"
"2989";"1660970";"2018-04-09";"89348";"2018-04-09";"H-852-17   OTROSI NRO 001";"2650418";"2597410";"53008";"0";"0";"0";"173900";"173900";"0";"0";"2423510";"2476518";"-53008"
"2990";"1663096";"2018-04-09";"89348";"2018-04-09";"H-852-17   OTROSI NRO 001";"3357366";"3290219";"67147";"0";"0";"0";"0";"0";"0";"0";"3290219";"3357366";"-67147"
"2991";"1664585";"2018-04-09";"89348";"2018-04-09";"H-852-17   OTROSI NRO 001";"2503000";"2452940";"50060";"0";"0";"0";"0";"0";"0";"0";"2452940";"2503000";"-50060"
"2992";"1664885";"2018-04-09";"89348";"2018-04-09";"H-852-17   OTROSI NRO 001";"4421996";"4333556";"88440";"0";"0";"0";"114700";"114700";"0";"0";"4218856";"4307296";"-88440"
"2993";"1656050";"2018-04-09";"89076";"2018-04-09";"H-852-17   OTROSI NRO 001";"2847137";"2790194";"56943";"0";"0";"0";"0";"0";"0";"0";"2790194";"2847137";"-56943"
"2994";"1662885";"2018-04-09";"89076";"2018-04-09";"H-852-17   OTROSI NRO 001";"46000";"45080";"920";"0";"0";"0";"0";"0";"0";"0";"45080";"46000";"-920"
"2995";"1662941";"2018-04-09";"89076";"2018-04-09";"H-852-17   OTROSI NRO 001";"46000";"45080";"920";"0";"0";"0";"0";"0";"0";"0";"45080";"46000";"-920"
"2996";"1662981";"2018-04-09";"89076";"2018-04-09";"H-852-17   OTROSI NRO 001";"46000";"45080";"920";"0";"0";"0";"0";"0";"0";"0";"45080";"46000";"-920"
"2997";"1663004";"2018-04-09";"89076";"2018-04-09";"H-852-17   OTROSI NRO 001";"56000";"54880";"1120";"0";"0";"0";"0";"0";"0";"0";"54880";"56000";"-1120"
"2998";"1663029";"2018-04-09";"89076";"2018-04-09";"H-852-17   OTROSI NRO 001";"46000";"45080";"920";"0";"0";"0";"0";"0";"0";"0";"45080";"46000";"-920"
"2999";"1663042";"2018-04-09";"89076";"2018-04-09";"H-852-17   OTROSI NRO 001";"46000";"45080";"920";"0";"0";"0";"0";"0";"0";"0";"45080";"46000";"-920"
"3000";"1663050";"2018-04-09";"89076";"2018-04-09";"H-852-17   OTROSI NRO 001";"56000";"54880";"1120";"0";"0";"0";"0";"0";"0";"0";"54880";"56000";"-1120"
"3001";"1663052";"2018-04-09";"89076";"2018-04-09";"H-852-17   OTROSI NRO 001";"56000";"54880";"1120";"0";"0";"0";"0";"0";"0";"0";"54880";"56000";"-1120"
"3002";"1663495";"2018-04-09";"89076";"2018-04-09";"H-852-17   OTROSI NRO 001";"56000";"54880";"1120";"0";"0";"0";"0";"0";"0";"0";"54880";"56000";"-1120"
"3003";"1663777";"2018-04-09";"89076";"2018-04-09";"H-852-17   OTROSI NRO 001";"38364";"37597";"767";"0";"0";"0";"0";"0";"0";"0";"37597";"38364";"-767"
"3004";"1663847";"2018-04-09";"89076";"2018-04-09";"H-852-17   OTROSI NRO 001";"112201";"109957";"2244";"0";"0";"0";"0";"0";"0";"0";"109957";"112201";"-2244"
"3005";"1663867";"2018-04-09";"89076";"2018-04-09";"H-852-17   OTROSI NRO 001";"46000";"45080";"920";"0";"0";"0";"0";"0";"0";"0";"45080";"46000";"-920"
"3006";"1664006";"2018-04-09";"89076";"2018-04-09";"H-852-17   OTROSI NRO 001";"114848";"112551";"2297";"0";"0";"0";"0";"0";"0";"0";"112551";"114848";"-2297"
"3007";"1664359";"2018-04-09";"89076";"2018-04-09";"H-852-17   OTROSI NRO 001";"46000";"45080";"920";"0";"0";"0";"0";"0";"0";"0";"45080";"46000";"-920"
"3008";"1664403";"2018-04-09";"89076";"2018-04-09";"H-852-17   OTROSI NRO 001";"46000";"45080";"920";"0";"0";"0";"0";"0";"0";"0";"45080";"46000";"-920"
"3009";"1664413";"2018-04-09";"89076";"2018-04-09";"H-852-17   OTROSI NRO 001";"56000";"54880";"1120";"0";"0";"0";"0";"0";"0";"0";"54880";"56000";"-1120"
"3010";"1664415";"2018-04-09";"89076";"2018-04-09";"H-852-17   OTROSI NRO 001";"90000";"88200";"1800";"0";"0";"0";"0";"0";"0";"0";"88200";"90000";"-1800"
"3011";"1664417";"2018-04-09";"89076";"2018-04-09";"H-852-17   OTROSI NRO 001";"56000";"54880";"1120";"0";"0";"0";"0";"0";"0";"0";"54880";"56000";"-1120"
"3012";"1664422";"2018-04-09";"89076";"2018-04-09";"H-852-17   OTROSI NRO 001";"90000";"88200";"1800";"0";"0";"0";"0";"0";"0";"0";"88200";"90000";"-1800"
"3013";"1664428";"2018-04-09";"89076";"2018-04-09";"H-852-17   OTROSI NRO 001";"46000";"45080";"920";"0";"0";"0";"0";"0";"0";"0";"45080";"46000";"-920"
"3014";"1664446";"2018-04-09";"89076";"2018-04-09";"H-852-17   OTROSI NRO 001";"180000";"176400";"3600";"0";"0";"0";"0";"0";"0";"0";"176400";"180000";"-3600"
"3015";"1664776";"2018-04-09";"89076";"2018-04-09";"H-852-17   OTROSI NRO 001";"46000";"45080";"920";"0";"0";"0";"0";"0";"0";"0";"45080";"46000";"-920"
"3016";"1664936";"2018-04-09";"89076";"2018-04-09";"H-852-17   OTROSI NRO 001";"736358";"721631";"14727";"0";"0";"0";"0";"0";"0";"0";"721631";"736358";"-14727"
"3017";"1656649";"2018-04-09";"89195";"2018-04-09";"H-852-17   OTROSI NRO 001";"180000";"176400";"3600";"0";"0";"0";"0";"0";"0";"0";"176400";"180000";"-3600"
"3018";"1659432";"2018-04-09";"89195";"2018-04-09";"H-852-17   OTROSI NRO 001";"274200";"268716";"5484";"0";"0";"0";"0";"0";"0";"0";"268716";"274200";"-5484"
"3019";"1661244";"2018-04-09";"89195";"2018-04-09";"H-852-17   OTROSI NRO 001";"247000";"242060";"4940";"0";"0";"0";"0";"0";"0";"0";"242060";"247000";"-4940"
"3020";"1661299";"2018-04-09";"89195";"2018-04-09";"H-852-17   OTROSI NRO 001";"35900";"35182";"718";"0";"0";"0";"0";"0";"0";"0";"35182";"35900";"-718"
"3021";"1662673";"2018-04-09";"89195";"2018-04-09";"H-852-17   OTROSI NRO 001";"274200";"268716";"5484";"0";"0";"0";"0";"0";"0";"0";"268716";"274200";"-5484"
"3022";"1662746";"2018-04-09";"89195";"2018-04-09";"H-852-17   OTROSI NRO 001";"548400";"537432";"10968";"0";"0";"0";"0";"0";"0";"0";"537432";"548400";"-10968"
"3023";"1663190";"2018-04-09";"89195";"2018-04-09";"H-852-17   OTROSI NRO 001";"70000";"68600";"1400";"0";"0";"0";"0";"0";"0";"0";"68600";"70000";"-1400"
"3024";"1663243";"2018-04-09";"89195";"2018-04-09";"H-852-17   OTROSI NRO 001";"180000";"176400";"3600";"0";"0";"0";"0";"0";"0";"0";"176400";"180000";"-3600"
"3025";"1663270";"2018-04-09";"89195";"2018-04-09";"H-852-17   OTROSI NRO 001";"56000";"54880";"1120";"0";"0";"0";"0";"0";"0";"0";"54880";"56000";"-1120"
"3026";"1663293";"2018-04-09";"89195";"2018-04-09";"H-852-17   OTROSI NRO 001";"70000";"68600";"1400";"0";"0";"0";"0";"0";"0";"0";"68600";"70000";"-1400"
"3027";"1663505";"2018-04-09";"89195";"2018-04-09";"H-852-17   OTROSI NRO 001";"46000";"45080";"920";"0";"0";"0";"0";"0";"0";"0";"45080";"46000";"-920"
"3028";"1663516";"2018-04-09";"89195";"2018-04-09";"H-852-17   OTROSI NRO 001";"56000";"54880";"1120";"0";"0";"0";"0";"0";"0";"0";"54880";"56000";"-1120"
"3029";"1663544";"2018-04-09";"89195";"2018-04-09";"H-852-17   OTROSI NRO 001";"46000";"45080";"920";"0";"0";"0";"0";"0";"0";"0";"45080";"46000";"-920"
"3030";"1663553";"2018-04-09";"89195";"2018-04-09";"H-852-17   OTROSI NRO 001";"46000";"45080";"920";"0";"0";"0";"0";"0";"0";"0";"45080";"46000";"-920"
"3031";"1663573";"2018-04-09";"89195";"2018-04-09";"H-852-17   OTROSI NRO 001";"46000";"45080";"920";"0";"0";"0";"0";"0";"0";"0";"45080";"46000";"-920"
"3032";"1663580";"2018-04-09";"89195";"2018-04-09";"H-852-17   OTROSI NRO 001";"112201";"109957";"2244";"0";"0";"0";"0";"0";"0";"0";"109957";"112201";"-2244"
"3033";"1663599";"2018-04-09";"89195";"2018-04-09";"H-852-17   OTROSI NRO 001";"56000";"54880";"1120";"0";"0";"0";"0";"0";"0";"0";"54880";"56000";"-1120"
"3034";"1663601";"2018-04-09";"89195";"2018-04-09";"H-852-17   OTROSI NRO 001";"46000";"45080";"920";"0";"0";"0";"0";"0";"0";"0";"45080";"46000";"-920"
"3035";"1663613";"2018-04-09";"89195";"2018-04-09";"H-852-17   OTROSI NRO 001";"180000";"176400";"3600";"0";"0";"0";"0";"0";"0";"0";"176400";"180000";"-3600"
"3036";"1663692";"2018-04-09";"89195";"2018-04-09";"H-852-17   OTROSI NRO 001";"46000";"45080";"920";"0";"0";"0";"0";"0";"0";"0";"45080";"46000";"-920"
"3037";"1663704";"2018-04-09";"89195";"2018-04-09";"H-852-17   OTROSI NRO 001";"56000";"54880";"1120";"0";"0";"0";"0";"0";"0";"0";"54880";"56000";"-1120"
"3038";"1663706";"2018-04-09";"89195";"2018-04-09";"H-852-17   OTROSI NRO 001";"56000";"54880";"1120";"0";"0";"0";"0";"0";"0";"0";"54880";"56000";"-1120"
"3039";"1663708";"2018-04-09";"89195";"2018-04-09";"H-852-17   OTROSI NRO 001";"46000";"45080";"920";"0";"0";"0";"0";"0";"0";"0";"45080";"46000";"-920"
"3040";"1663978";"2018-04-09";"89195";"2018-04-09";"H-852-17   OTROSI NRO 001";"274200";"268716";"5484";"0";"0";"0";"0";"0";"0";"0";"268716";"274200";"-5484"
"3041";"1664015";"2018-04-09";"89195";"2018-04-09";"H-852-17   OTROSI NRO 001";"46000";"45080";"920";"0";"0";"0";"0";"0";"0";"0";"45080";"46000";"-920"
"3042";"1664017";"2018-04-09";"89195";"2018-04-09";"H-852-17   OTROSI NRO 001";"46000";"45080";"920";"0";"0";"0";"0";"0";"0";"0";"45080";"46000";"-920"
"3043";"1664021";"2018-04-09";"89195";"2018-04-09";"H-852-17   OTROSI NRO 001";"56000";"54880";"1120";"0";"0";"0";"0";"0";"0";"0";"54880";"56000";"-1120"
"3044";"1664132";"2018-04-09";"89195";"2018-04-09";"H-852-17   OTROSI NRO 001";"35900";"35182";"718";"0";"0";"0";"0";"0";"0";"0";"35182";"35900";"-718"
"3045";"1664155";"2018-04-09";"89195";"2018-04-09";"H-852-17   OTROSI NRO 001";"17700";"17346";"354";"0";"0";"0";"0";"0";"0";"0";"17346";"17700";"-354"
"3046";"1664302";"2018-04-09";"89195";"2018-04-09";"H-852-17   OTROSI NRO 001";"46000";"45080";"920";"0";"0";"0";"0";"0";"0";"0";"45080";"46000";"-920"
"3047";"1664327";"2018-04-09";"89195";"2018-04-09";"H-852-17   OTROSI NRO 001";"274200";"268716";"5484";"0";"0";"0";"0";"0";"0";"0";"268716";"274200";"-5484"
"3048";"1664470";"2018-04-09";"89195";"2018-04-09";"H-852-17   OTROSI NRO 001";"56000";"54880";"1120";"0";"0";"0";"0";"0";"0";"0";"54880";"56000";"-1120"
"3049";"1664617";"2018-04-09";"89195";"2018-04-09";"H-852-17   OTROSI NRO 001";"147500";"144550";"2950";"0";"0";"0";"0";"0";"0";"0";"144550";"147500";"-2950"
"3050";"1664627";"2018-04-09";"89195";"2018-04-09";"H-852-17   OTROSI NRO 001";"41601";"40769";"832";"0";"0";"0";"0";"0";"0";"0";"40769";"41601";"-832"
"3051";"1664642";"2018-04-09";"89195";"2018-04-09";"H-852-17   OTROSI NRO 001";"46000";"45080";"920";"0";"0";"0";"0";"0";"0";"0";"45080";"46000";"-920"
"3052";"1652637";"2018-04-09";"88908";"2018-04-09";"H-852-17   OTROSI NRO 001";"274200";"268716";"5484";"0";"0";"0";"0";"0";"0";"0";"268716";"274200";"-5484"
"3053";"1652659";"2018-04-09";"88908";"2018-04-09";"H-852-17   OTROSI NRO 001";"147500";"144550";"2950";"0";"0";"0";"0";"0";"0";"0";"144550";"147500";"-2950"
"3054";"1653168";"2018-04-09";"88908";"2018-04-09";"H-852-17   OTROSI NRO 001";"274200";"268716";"5484";"0";"0";"0";"0";"0";"0";"0";"268716";"274200";"-5484"
"3055";"1656341";"2018-04-09";"88908";"2018-04-09";"H-852-17   OTROSI NRO 001";"274200";"268716";"5484";"0";"0";"0";"0";"0";"0";"0";"268716";"274200";"-5484"
"3056";"1657349";"2018-04-09";"88908";"2018-04-09";"H-852-17   OTROSI NRO 001";"46000";"45080";"920";"0";"0";"0";"0";"0";"0";"0";"45080";"46000";"-920"
"3057";"1657526";"2018-04-09";"88908";"2018-04-09";"H-852-17   OTROSI NRO 001";"46000";"45080";"920";"0";"0";"0";"0";"0";"0";"0";"45080";"46000";"-920"
"3058";"1657547";"2018-04-09";"88908";"2018-04-09";"H-852-17   OTROSI NRO 001";"46000";"45080";"920";"0";"0";"0";"0";"0";"0";"0";"45080";"46000";"-920"
"3059";"1657715";"2018-04-09";"88908";"2018-04-09";"H-852-17   OTROSI NRO 001";"70000";"68600";"1400";"0";"0";"0";"0";"0";"0";"0";"68600";"70000";"-1400"
"3060";"1658292";"2018-04-09";"88908";"2018-04-09";"H-852-17   OTROSI NRO 001";"70000";"68600";"1400";"0";"0";"0";"0";"0";"0";"0";"68600";"70000";"-1400"
"3061";"1658309";"2018-04-09";"88908";"2018-04-09";"H-852-17   OTROSI NRO 001";"46000";"45080";"920";"0";"0";"0";"0";"0";"0";"0";"45080";"46000";"-920"
"3062";"1658315";"2018-04-09";"88908";"2018-04-09";"H-852-17   OTROSI NRO 001";"56000";"54880";"1120";"0";"0";"0";"0";"0";"0";"0";"54880";"56000";"-1120"
"3063";"1658319";"2018-04-09";"88908";"2018-04-09";"H-852-17   OTROSI NRO 001";"56000";"54880";"1120";"0";"0";"0";"0";"0";"0";"0";"54880";"56000";"-1120"
"3064";"1658322";"2018-04-09";"88908";"2018-04-09";"H-852-17   OTROSI NRO 001";"46000";"45080";"920";"0";"0";"0";"0";"0";"0";"0";"45080";"46000";"-920"
"3065";"1658361";"2018-04-09";"88908";"2018-04-09";"H-852-17   OTROSI NRO 001";"56000";"54880";"1120";"0";"0";"0";"0";"0";"0";"0";"54880";"56000";"-1120"
"3066";"1658443";"2018-04-09";"88908";"2018-04-09";"H-852-17   OTROSI NRO 001";"56000";"54880";"1120";"0";"0";"0";"0";"0";"0";"0";"54880";"56000";"-1120"
"3067";"1658470";"2018-04-09";"88908";"2018-04-09";"H-852-17   OTROSI NRO 001";"46000";"45080";"920";"0";"0";"0";"0";"0";"0";"0";"45080";"46000";"-920"
"3068";"1658571";"2018-04-09";"88908";"2018-04-09";"H-852-17   OTROSI NRO 001";"27571";"27020";"551";"0";"0";"0";"0";"0";"0";"0";"27020";"27571";"-551"
"3069";"1658856";"2018-04-09";"88908";"2018-04-09";"H-852-17   OTROSI NRO 001";"46000";"45080";"920";"0";"0";"0";"0";"0";"0";"0";"45080";"46000";"-920"
"3070";"1658877";"2018-04-09";"88908";"2018-04-09";"H-852-17   OTROSI NRO 001";"56000";"54880";"1120";"0";"0";"0";"0";"0";"0";"0";"54880";"56000";"-1120"
"3071";"1658884";"2018-04-09";"88908";"2018-04-09";"H-852-17   OTROSI NRO 001";"70000";"68600";"1400";"0";"0";"0";"0";"0";"0";"0";"68600";"70000";"-1400"
"3072";"1658920";"2018-04-09";"88908";"2018-04-09";"H-852-17   OTROSI NRO 001";"46000";"45080";"920";"0";"0";"0";"0";"0";"0";"0";"45080";"46000";"-920"
"3073";"1658942";"2018-04-09";"88908";"2018-04-09";"H-852-17   OTROSI NRO 001";"35000";"34300";"700";"0";"0";"0";"0";"0";"0";"0";"34300";"35000";"-700"
"3074";"1658961";"2018-04-09";"88908";"2018-04-09";"H-852-17   OTROSI NRO 001";"56000";"54880";"1120";"0";"0";"0";"0";"0";"0";"0";"54880";"56000";"-1120"
"3075";"1658964";"2018-04-09";"88908";"2018-04-09";"H-852-17   OTROSI NRO 001";"46000";"45080";"920";"0";"0";"0";"0";"0";"0";"0";"45080";"46000";"-920"
"3076";"1658978";"2018-04-09";"88908";"2018-04-09";"H-852-17   OTROSI NRO 001";"46000";"45080";"920";"0";"0";"0";"0";"0";"0";"0";"45080";"46000";"-920"
"3077";"1660262";"2018-04-09";"88908";"2018-04-09";"H-852-17   OTROSI NRO 001";"56000";"54880";"1120";"0";"0";"0";"0";"0";"0";"0";"54880";"56000";"-1120"
"3078";"1660266";"2018-04-09";"88908";"2018-04-09";"H-852-17   OTROSI NRO 001";"56000";"54880";"1120";"0";"0";"0";"0";"0";"0";"0";"54880";"56000";"-1120"
"3079";"1660280";"2018-04-09";"88908";"2018-04-09";"H-852-17   OTROSI NRO 001";"35000";"34300";"700";"0";"0";"0";"0";"0";"0";"0";"34300";"35000";"-700"
"3080";"1660318";"2018-04-09";"88908";"2018-04-09";"H-852-17   OTROSI NRO 001";"70000";"68600";"1400";"0";"0";"0";"0";"0";"0";"0";"68600";"70000";"-1400"
"3081";"1660325";"2018-04-09";"88908";"2018-04-09";"H-852-17   OTROSI NRO 001";"35000";"34300";"700";"0";"0";"0";"0";"0";"0";"0";"34300";"35000";"-700"
"3082";"1660355";"2018-04-09";"88908";"2018-04-09";"H-852-17   OTROSI NRO 001";"180000";"176400";"3600";"0";"0";"0";"0";"0";"0";"0";"176400";"180000";"-3600"
"3083";"1660357";"2018-04-09";"88908";"2018-04-09";"H-852-17   OTROSI NRO 001";"46000";"45080";"920";"0";"0";"0";"0";"0";"0";"0";"45080";"46000";"-920"
"3084";"1660374";"2018-04-09";"88908";"2018-04-09";"H-852-17   OTROSI NRO 001";"46000";"45080";"920";"0";"0";"0";"0";"0";"0";"0";"45080";"46000";"-920"
"3085";"1660389";"2018-04-09";"88908";"2018-04-09";"H-852-17   OTROSI NRO 001";"46000";"45080";"920";"0";"0";"0";"0";"0";"0";"0";"45080";"46000";"-920"
"3086";"1660406";"2018-04-09";"88908";"2018-04-09";"H-852-17   OTROSI NRO 001";"46000";"45080";"920";"0";"0";"0";"0";"0";"0";"0";"45080";"46000";"-920"
"3087";"1660336";"2018-04-09";"89029";"2018-04-09";"H-852-17   OTROSI NRO 001";"70000";"68600";"1400";"0";"0";"0";"0";"0";"0";"0";"68600";"70000";"-1400"
"3088";"1660848";"2018-04-09";"89029";"2018-04-09";"H-852-17   OTROSI NRO 001";"35000";"34300";"700";"0";"0";"0";"0";"0";"0";"0";"34300";"35000";"-700"
"3089";"1660934";"2018-04-09";"89029";"2018-04-09";"H-852-17   OTROSI NRO 001";"35000";"34300";"700";"0";"0";"0";"0";"0";"0";"0";"34300";"35000";"-700"
"3090";"1660939";"2018-04-09";"89029";"2018-04-09";"H-852-17   OTROSI NRO 001";"35000";"34300";"700";"0";"0";"0";"0";"0";"0";"0";"34300";"35000";"-700"
"3091";"1661245";"2018-04-09";"89029";"2018-04-09";"H-852-17   OTROSI NRO 001";"56000";"54880";"1120";"0";"0";"0";"0";"0";"0";"0";"54880";"56000";"-1120"
"3092";"1661248";"2018-04-09";"89029";"2018-04-09";"H-852-17   OTROSI NRO 001";"56000";"54880";"1120";"0";"0";"0";"0";"0";"0";"0";"54880";"56000";"-1120"
"3093";"1661267";"2018-04-09";"89029";"2018-04-09";"H-852-17   OTROSI NRO 001";"46000";"45080";"920";"0";"0";"0";"0";"0";"0";"0";"45080";"46000";"-920"
"3094";"1661273";"2018-04-09";"89029";"2018-04-09";"H-852-17   OTROSI NRO 001";"46000";"45080";"920";"0";"0";"0";"0";"0";"0";"0";"45080";"46000";"-920"
"3095";"1661298";"2018-04-09";"89029";"2018-04-09";"H-852-17   OTROSI NRO 001";"41601";"40769";"832";"0";"0";"0";"0";"0";"0";"0";"40769";"41601";"-832"
"3096";"1661303";"2018-04-09";"89029";"2018-04-09";"H-852-17   OTROSI NRO 001";"41601";"40769";"832";"0";"0";"0";"0";"0";"0";"0";"40769";"41601";"-832"
"3097";"1661316";"2018-04-09";"89029";"2018-04-09";"H-852-17   OTROSI NRO 001";"46000";"45080";"920";"0";"0";"0";"0";"0";"0";"0";"45080";"46000";"-920"
"3098";"1661440";"2018-04-09";"89029";"2018-04-09";"H-852-17   OTROSI NRO 001";"46000";"45080";"920";"0";"0";"0";"0";"0";"0";"0";"45080";"46000";"-920"
"3099";"1661441";"2018-04-09";"89029";"2018-04-09";"H-852-17   OTROSI NRO 001";"35000";"34300";"700";"0";"0";"0";"0";"0";"0";"0";"34300";"35000";"-700"
"3100";"1661447";"2018-04-09";"89029";"2018-04-09";"H-852-17   OTROSI NRO 001";"180000";"176400";"3600";"0";"0";"0";"0";"0";"0";"0";"176400";"180000";"-3600"
"3101";"1661461";"2018-04-09";"89029";"2018-04-09";"H-852-17   OTROSI NRO 001";"46000";"45080";"920";"0";"0";"0";"0";"0";"0";"0";"45080";"46000";"-920"
"3102";"1661486";"2018-04-09";"89029";"2018-04-09";"H-852-17   OTROSI NRO 001";"46000";"45080";"920";"0";"0";"0";"0";"0";"0";"0";"45080";"46000";"-920"
"3103";"1661509";"2018-04-09";"89029";"2018-04-09";"H-852-17   OTROSI NRO 001";"70000";"68600";"1400";"0";"0";"0";"0";"0";"0";"0";"68600";"70000";"-1400"
"3104";"1661698";"2018-04-09";"89029";"2018-04-09";"H-852-17   OTROSI NRO 001";"35000";"34300";"700";"0";"0";"0";"0";"0";"0";"0";"34300";"35000";"-700"
"3105";"1661712";"2018-04-09";"89029";"2018-04-09";"H-852-17   OTROSI NRO 001";"35000";"34300";"700";"0";"0";"0";"0";"0";"0";"0";"34300";"35000";"-700"
"3106";"1661772";"2018-04-09";"89029";"2018-04-09";"H-852-17   OTROSI NRO 001";"46000";"45080";"920";"0";"0";"0";"0";"0";"0";"0";"45080";"46000";"-920"
"3107";"1661837";"2018-04-09";"89029";"2018-04-09";"H-852-17   OTROSI NRO 001";"35000";"34300";"700";"0";"0";"0";"0";"0";"0";"0";"34300";"35000";"-700"
"3108";"1661939";"2018-04-09";"89029";"2018-04-09";"H-852-17   OTROSI NRO 001";"46000";"45080";"920";"0";"0";"0";"0";"0";"0";"0";"45080";"46000";"-920"
"3109";"1661965";"2018-04-09";"89029";"2018-04-09";"H-852-17   OTROSI NRO 001";"56000";"54880";"1120";"0";"0";"0";"0";"0";"0";"0";"54880";"56000";"-1120"
"3110";"1661990";"2018-04-09";"89029";"2018-04-09";"H-852-17   OTROSI NRO 001";"311000";"304780";"6220";"0";"0";"0";"0";"0";"0";"0";"304780";"311000";"-6220"
"3111";"1662007";"2018-04-09";"89029";"2018-04-09";"H-852-17   OTROSI NRO 001";"46000";"45080";"920";"0";"0";"0";"0";"0";"0";"0";"45080";"46000";"-920"
"3112";"1662030";"2018-04-09";"89029";"2018-04-09";"H-852-17   OTROSI NRO 001";"46000";"45080";"920";"0";"0";"0";"0";"0";"0";"0";"45080";"46000";"-920"
"3113";"1662035";"2018-04-09";"89029";"2018-04-09";"H-852-17   OTROSI NRO 001";"46000";"45080";"920";"0";"0";"0";"0";"0";"0";"0";"45080";"46000";"-920"
"3114";"1662036";"2018-04-09";"89029";"2018-04-09";"H-852-17   OTROSI NRO 001";"46000";"45080";"920";"0";"0";"0";"0";"0";"0";"0";"45080";"46000";"-920"
"3115";"1662038";"2018-04-09";"89029";"2018-04-09";"H-852-17   OTROSI NRO 001";"46000";"45080";"920";"0";"0";"0";"0";"0";"0";"0";"45080";"46000";"-920"
"3116";"1662041";"2018-04-09";"89029";"2018-04-09";"H-852-17   OTROSI NRO 001";"46000";"45080";"920";"0";"0";"0";"0";"0";"0";"0";"45080";"46000";"-920"
"3117";"1662056";"2018-04-09";"89029";"2018-04-09";"H-852-17   OTROSI NRO 001";"35000";"34300";"700";"0";"0";"0";"0";"0";"0";"0";"34300";"35000";"-700"
"3118";"1662067";"2018-04-09";"89029";"2018-04-09";"H-852-17   OTROSI NRO 001";"35000";"34300";"700";"0";"0";"0";"0";"0";"0";"0";"34300";"35000";"-700"
"3119";"1662077";"2018-04-09";"89029";"2018-04-09";"H-852-17   OTROSI NRO 001";"46000";"45080";"920";"0";"0";"0";"0";"0";"0";"0";"45080";"46000";"-920"
"3120";"1662083";"2018-04-09";"89029";"2018-04-09";"H-852-17   OTROSI NRO 001";"46000";"45080";"920";"0";"0";"0";"0";"0";"0";"0";"45080";"46000";"-920"
"3121";"1662087";"2018-04-09";"89029";"2018-04-09";"H-852-17   OTROSI NRO 001";"46000";"45080";"920";"0";"0";"0";"0";"0";"0";"0";"45080";"46000";"-920"
"3122";"1652360";"2018-04-09";"88914";"2018-04-09";"H-852-17   OTROSI NRO 001";"56000";"54880";"1120";"0";"0";"0";"0";"0";"0";"0";"54880";"56000";"-1120"
"3123";"1652455";"2018-04-09";"88914";"2018-04-09";"H-852-17   OTROSI NRO 001";"56000";"54880";"1120";"0";"0";"0";"0";"0";"0";"0";"54880";"56000";"-1120"
"3124";"1652652";"2018-04-09";"88914";"2018-04-09";"H-852-17   OTROSI NRO 001";"70000";"68600";"1400";"0";"0";"0";"0";"0";"0";"0";"68600";"70000";"-1400"
"3125";"1652677";"2018-04-09";"88914";"2018-04-09";"H-852-17   OTROSI NRO 001";"46000";"45080";"920";"0";"0";"0";"0";"0";"0";"0";"45080";"46000";"-920"
"3126";"1652954";"2018-04-09";"88914";"2018-04-09";"H-852-17   OTROSI NRO 001";"70000";"68600";"1400";"0";"0";"0";"0";"0";"0";"0";"68600";"70000";"-1400"
"3127";"1653158";"2018-04-09";"88914";"2018-04-09";"H-852-17   OTROSI NRO 001";"46000";"45080";"920";"0";"0";"0";"0";"0";"0";"0";"45080";"46000";"-920"
"3128";"1653903";"2018-04-09";"88914";"2018-04-09";"H-852-17   OTROSI NRO 001";"56000";"54880";"1120";"0";"0";"0";"0";"0";"0";"0";"54880";"56000";"-1120"
"3129";"1654024";"2018-04-09";"88914";"2018-04-09";"H-852-17   OTROSI NRO 001";"46000";"45080";"920";"0";"0";"0";"0";"0";"0";"0";"45080";"46000";"-920"
"3130";"1654117";"2018-04-09";"88914";"2018-04-09";"H-852-17   OTROSI NRO 001";"46000";"45080";"920";"0";"0";"0";"0";"0";"0";"0";"45080";"46000";"-920"
"3131";"1654145";"2018-04-09";"88914";"2018-04-09";"H-852-17   OTROSI NRO 001";"70000";"68600";"1400";"0";"0";"0";"0";"0";"0";"0";"68600";"70000";"-1400"
"3132";"1654162";"2018-04-09";"88914";"2018-04-09";"H-852-17   OTROSI NRO 001";"46000";"45080";"920";"0";"0";"0";"0";"0";"0";"0";"45080";"46000";"-920"
"3133";"1654165";"2018-04-09";"88914";"2018-04-09";"H-852-17   OTROSI NRO 001";"56000";"54880";"1120";"0";"0";"0";"0";"0";"0";"0";"54880";"56000";"-1120"
"3134";"1654171";"2018-04-09";"88914";"2018-04-09";"H-852-17   OTROSI NRO 001";"46000";"45080";"920";"0";"0";"0";"0";"0";"0";"0";"45080";"46000";"-920"
"3135";"1654182";"2018-04-09";"88914";"2018-04-09";"H-852-17   OTROSI NRO 001";"56000";"54880";"1120";"0";"0";"0";"0";"0";"0";"0";"54880";"56000";"-1120"
"3136";"1654210";"2018-04-09";"88914";"2018-04-09";"H-852-17   OTROSI NRO 001";"56000";"54880";"1120";"0";"0";"0";"0";"0";"0";"0";"54880";"56000";"-1120"
"3137";"1654214";"2018-04-09";"88914";"2018-04-09";"H-852-17   OTROSI NRO 001";"46000";"45080";"920";"0";"0";"0";"0";"0";"0";"0";"45080";"46000";"-920"
"3138";"1654240";"2018-04-09";"88914";"2018-04-09";"H-852-17   OTROSI NRO 001";"46000";"45080";"920";"0";"0";"0";"0";"0";"0";"0";"45080";"46000";"-920"
"3139";"1656322";"2018-04-09";"88914";"2018-04-09";"H-852-17   OTROSI NRO 001";"46000";"45080";"920";"0";"0";"0";"0";"0";"0";"0";"45080";"46000";"-920"
"3140";"1656347";"2018-04-09";"88914";"2018-04-09";"H-852-17   OTROSI NRO 001";"46000";"45080";"920";"0";"0";"0";"0";"0";"0";"0";"45080";"46000";"-920"
"3141";"1656433";"2018-04-09";"88914";"2018-04-09";"H-852-17   OTROSI NRO 001";"70000";"68600";"1400";"0";"0";"0";"0";"0";"0";"0";"68600";"70000";"-1400"
"3142";"1656438";"2018-04-09";"88914";"2018-04-09";"H-852-17   OTROSI NRO 001";"35000";"34300";"700";"0";"0";"0";"0";"0";"0";"0";"34300";"35000";"-700"
"3143";"1656513";"2018-04-09";"88914";"2018-04-09";"H-852-17   OTROSI NRO 001";"35000";"34300";"700";"0";"0";"0";"0";"0";"0";"0";"34300";"35000";"-700"
"3144";"1656516";"2018-04-09";"88914";"2018-04-09";"H-852-17   OTROSI NRO 001";"35000";"34300";"700";"0";"0";"0";"0";"0";"0";"0";"34300";"35000";"-700"
"3145";"1656532";"2018-04-09";"88914";"2018-04-09";"H-852-17   OTROSI NRO 001";"46000";"45080";"920";"0";"0";"0";"0";"0";"0";"0";"45080";"46000";"-920"
"3146";"1656538";"2018-04-09";"88914";"2018-04-09";"H-852-17   OTROSI NRO 001";"46000";"45080";"920";"0";"0";"0";"0";"0";"0";"0";"45080";"46000";"-920"
"3147";"1656644";"2018-04-09";"88914";"2018-04-09";"H-852-17   OTROSI NRO 001";"46000";"45080";"920";"0";"0";"0";"0";"0";"0";"0";"45080";"46000";"-920"
"3148";"1656729";"2018-04-09";"88914";"2018-04-09";"H-852-17   OTROSI NRO 001";"46000";"45080";"920";"0";"0";"0";"0";"0";"0";"0";"45080";"46000";"-920"
"3149";"1656741";"2018-04-09";"88914";"2018-04-09";"H-852-17   OTROSI NRO 001";"70000";"68600";"1400";"0";"0";"0";"0";"0";"0";"0";"68600";"70000";"-1400"
"3150";"1656746";"2018-04-09";"88914";"2018-04-09";"H-852-17   OTROSI NRO 001";"46000";"45080";"920";"0";"0";"0";"0";"0";"0";"0";"45080";"46000";"-920"
"3151";"1656766";"2018-04-09";"88914";"2018-04-09";"H-852-17   OTROSI NRO 001";"46000";"45080";"920";"0";"0";"0";"0";"0";"0";"0";"45080";"46000";"-920"
"3152";"1656911";"2018-04-09";"88914";"2018-04-09";"H-852-17   OTROSI NRO 001";"1003700";"983626";"20074";"0";"0";"0";"223000";"111500";"111500";"0";"872126";"797421";"74705"
"3153";"1656967";"2018-04-09";"88914";"2018-04-09";"H-852-17   OTROSI NRO 001";"70000";"68600";"1400";"0";"0";"0";"0";"0";"0";"0";"68600";"70000";"-1400"
"3154";"1656987";"2018-04-09";"88914";"2018-04-09";"H-852-17   OTROSI NRO 001";"46000";"45080";"920";"0";"0";"0";"0";"0";"0";"0";"45080";"46000";"-920"
"3155";"1657010";"2018-04-09";"88914";"2018-04-09";"H-852-17   OTROSI NRO 001";"46000";"45080";"920";"0";"0";"0";"0";"0";"0";"0";"45080";"46000";"-920"
"3156";"1657034";"2018-04-09";"88914";"2018-04-09";"H-852-17   OTROSI NRO 001";"46000";"45080";"920";"0";"0";"0";"0";"0";"0";"0";"45080";"46000";"-920"
"3157";"1669378";"2018-04-09";"89662";"2018-04-09";"0";"47741198";"46786374";"954824";"0";"0";"0";"4480006";"1888628";"2591378";"0";"44897746";"739200";"44158546"
"3158";"1654661";"2018-04-09";"88922";"2018-04-09";"H-852-17   OTROSI NRO 001";"82165";"80522";"1643";"0";"0";"0";"14646";"14646";"0";"0";"65876";"67519";"-1643"
"3159";"1654702";"2018-04-09";"88922";"2018-04-09";"H-852-17   OTROSI NRO 001";"46000";"45080";"920";"0";"0";"0";"0";"0";"0";"0";"45080";"46000";"-920"
"3160";"1654707";"2018-04-09";"88922";"2018-04-09";"H-852-17   OTROSI NRO 001";"35000";"34300";"700";"0";"0";"0";"0";"0";"0";"0";"34300";"35000";"-700"
"3161";"1654809";"2018-04-09";"88922";"2018-04-09";"H-852-17   OTROSI NRO 001";"56000";"54880";"1120";"0";"0";"0";"0";"0";"0";"0";"54880";"56000";"-1120"
"3162";"1654814";"2018-04-09";"88922";"2018-04-09";"H-852-17   OTROSI NRO 001";"138964";"136185";"2779";"0";"0";"0";"0";"0";"0";"0";"136185";"138964";"-2779"
"3163";"1654832";"2018-04-09";"88922";"2018-04-09";"H-852-17   OTROSI NRO 001";"70000";"68600";"1400";"0";"0";"0";"0";"0";"0";"0";"68600";"70000";"-1400"
"3164";"1654837";"2018-04-09";"88922";"2018-04-09";"H-852-17   OTROSI NRO 001";"46000";"45080";"920";"0";"0";"0";"0";"0";"0";"0";"45080";"46000";"-920"
"3165";"1654873";"2018-04-09";"88922";"2018-04-09";"H-852-17   OTROSI NRO 001";"70000";"68600";"1400";"0";"0";"0";"0";"0";"0";"0";"68600";"70000";"-1400"
"3166";"1654959";"2018-04-09";"88922";"2018-04-09";"H-852-17   OTROSI NRO 001";"70000";"68600";"1400";"0";"0";"0";"0";"0";"0";"0";"68600";"70000";"-1400"
"3167";"1654963";"2018-04-09";"88922";"2018-04-09";"H-852-17   OTROSI NRO 001";"56000";"54880";"1120";"0";"0";"0";"0";"0";"0";"0";"54880";"56000";"-1120"
"3168";"1654981";"2018-04-09";"88922";"2018-04-09";"H-852-17   OTROSI NRO 001";"46000";"45080";"920";"0";"0";"0";"0";"0";"0";"0";"45080";"46000";"-920"
"3169";"1655037";"2018-04-09";"88922";"2018-04-09";"H-852-17   OTROSI NRO 001";"129966";"127367";"2599";"0";"0";"0";"0";"0";"0";"0";"127367";"129966";"-2599"
"3170";"1655152";"2018-04-09";"88922";"2018-04-09";"H-852-17   OTROSI NRO 001";"56000";"54880";"1120";"0";"0";"0";"0";"0";"0";"0";"54880";"56000";"-1120"
"3171";"1655175";"2018-04-09";"88922";"2018-04-09";"H-852-17   OTROSI NRO 001";"66269";"64944";"1325";"0";"0";"0";"0";"0";"0";"0";"64944";"66269";"-1325"
"3172";"1655185";"2018-04-09";"88922";"2018-04-09";"H-852-17   OTROSI NRO 001";"46000";"45080";"920";"0";"0";"0";"0";"0";"0";"0";"45080";"46000";"-920"
"3173";"1655195";"2018-04-09";"88922";"2018-04-09";"H-852-17   OTROSI NRO 001";"259932";"254733";"5199";"0";"0";"0";"0";"0";"0";"0";"254733";"259932";"-5199"
"3174";"1655209";"2018-04-09";"88922";"2018-04-09";"H-852-17   OTROSI NRO 001";"46000";"45080";"920";"0";"0";"0";"0";"0";"0";"0";"45080";"46000";"-920"
"3175";"1655215";"2018-04-09";"88922";"2018-04-09";"H-852-17   OTROSI NRO 001";"46000";"45080";"920";"0";"0";"0";"0";"0";"0";"0";"45080";"46000";"-920"
"3176";"1655227";"2018-04-09";"88922";"2018-04-09";"H-852-17   OTROSI NRO 001";"41601";"40769";"832";"0";"0";"0";"0";"0";"0";"0";"40769";"41601";"-832"
"3177";"1655245";"2018-04-09";"88922";"2018-04-09";"H-852-17   OTROSI NRO 001";"70000";"68600";"1400";"0";"0";"0";"0";"0";"0";"0";"68600";"70000";"-1400"
"3178";"1655277";"2018-04-09";"88922";"2018-04-09";"H-852-17   OTROSI NRO 001";"46000";"45080";"920";"0";"0";"0";"0";"0";"0";"0";"45080";"46000";"-920"
"3179";"1655284";"2018-04-09";"88922";"2018-04-09";"H-852-17   OTROSI NRO 001";"46000";"45080";"920";"0";"0";"0";"0";"0";"0";"0";"45080";"46000";"-920"
"3180";"1655323";"2018-04-09";"88922";"2018-04-09";"H-852-17   OTROSI NRO 001";"56000";"54880";"1120";"0";"0";"0";"0";"0";"0";"0";"54880";"56000";"-1120"
"3181";"1655425";"2018-04-09";"88922";"2018-04-09";"H-852-17   OTROSI NRO 001";"56000";"54880";"1120";"0";"0";"0";"0";"0";"0";"0";"54880";"56000";"-1120"
"3182";"1655470";"2018-04-09";"88922";"2018-04-09";"H-852-17   OTROSI NRO 001";"70000";"68600";"1400";"0";"0";"0";"0";"0";"0";"0";"68600";"70000";"-1400"
"3183";"1655603";"2018-04-09";"88922";"2018-04-09";"H-852-17   OTROSI NRO 001";"46000";"45080";"920";"0";"0";"0";"0";"0";"0";"0";"45080";"46000";"-920"
"3184";"1655626";"2018-04-09";"88922";"2018-04-09";"H-852-17   OTROSI NRO 001";"46000";"45080";"920";"0";"0";"0";"0";"0";"0";"0";"45080";"46000";"-920"
"3185";"1655750";"2018-04-09";"88922";"2018-04-09";"H-852-17   OTROSI NRO 001";"46000";"45080";"920";"0";"0";"0";"0";"0";"0";"0";"45080";"46000";"-920"
"3186";"1655761";"2018-04-09";"88922";"2018-04-09";"H-852-17   OTROSI NRO 001";"35000";"34300";"700";"0";"0";"0";"0";"0";"0";"0";"34300";"35000";"-700"
"3187";"1655831";"2018-04-09";"88922";"2018-04-09";"H-852-17   OTROSI NRO 001";"35000";"34300";"700";"0";"0";"0";"0";"0";"0";"0";"34300";"35000";"-700"
"3188";"1655836";"2018-04-09";"88922";"2018-04-09";"H-852-17   OTROSI NRO 001";"46000";"45080";"920";"0";"0";"0";"0";"0";"0";"0";"45080";"46000";"-920"
"3189";"1655904";"2018-04-09";"88922";"2018-04-09";"H-852-17   OTROSI NRO 001";"70000";"68600";"1400";"0";"0";"0";"0";"0";"0";"0";"68600";"70000";"-1400"
"3190";"1655928";"2018-04-09";"88922";"2018-04-09";"H-852-17   OTROSI NRO 001";"46000";"45080";"920";"0";"0";"0";"0";"0";"0";"0";"45080";"46000";"-920"
"3191";"1655937";"2018-04-09";"88922";"2018-04-09";"H-852-17   OTROSI NRO 001";"46000";"45080";"920";"0";"0";"0";"0";"0";"0";"0";"45080";"46000";"-920"
"3192";"1656007";"2018-04-09";"88922";"2018-04-09";"H-852-17   OTROSI NRO 001";"46000";"45080";"920";"0";"0";"0";"0";"0";"0";"0";"45080";"46000";"-920"
"3193";"1652216";"2018-04-09";"88906";"2018-04-09";"H-852-17   OTROSI NRO 001";"548400";"537432";"10968";"0";"0";"0";"0";"0";"0";"0";"537432";"548400";"-10968"
"3194";"1652707";"2018-04-09";"88906";"2018-04-09";"H-852-17   OTROSI NRO 001";"274200";"268716";"5484";"0";"0";"0";"0";"0";"0";"0";"268716";"274200";"-5484"
"3195";"1653064";"2018-04-09";"88906";"2018-04-09";"H-852-17   OTROSI NRO 001";"274200";"268716";"5484";"0";"0";"0";"0";"0";"0";"0";"268716";"274200";"-5484"
"3196";"1657354";"2018-04-09";"88906";"2018-04-09";"H-852-17   OTROSI NRO 001";"46000";"45080";"920";"0";"0";"0";"0";"0";"0";"0";"45080";"46000";"-920"
"3197";"1657523";"2018-04-09";"88906";"2018-04-09";"H-852-17   OTROSI NRO 001";"46000";"45080";"920";"0";"0";"0";"0";"0";"0";"0";"45080";"46000";"-920"
"3198";"1657771";"2018-04-09";"88906";"2018-04-09";"H-852-17   OTROSI NRO 001";"38364";"37597";"767";"0";"0";"0";"0";"0";"0";"0";"37597";"38364";"-767"
"3199";"1657790";"2018-04-09";"88906";"2018-04-09";"H-852-17   OTROSI NRO 001";"46000";"45080";"920";"0";"0";"0";"0";"0";"0";"0";"45080";"46000";"-920"
"3200";"1657793";"2018-04-09";"88906";"2018-04-09";"H-852-17   OTROSI NRO 001";"46000";"45080";"920";"0";"0";"0";"0";"0";"0";"0";"45080";"46000";"-920"
"3201";"1658090";"2018-04-09";"88906";"2018-04-09";"H-852-17   OTROSI NRO 001";"46000";"45080";"920";"0";"0";"0";"0";"0";"0";"0";"45080";"46000";"-920"
"3202";"1658176";"2018-04-09";"88906";"2018-04-09";"H-852-17   OTROSI NRO 001";"35000";"34300";"700";"0";"0";"0";"0";"0";"0";"0";"34300";"35000";"-700"
"3203";"1658194";"2018-04-09";"88906";"2018-04-09";"H-852-17   OTROSI NRO 001";"180000";"176400";"3600";"0";"0";"0";"0";"0";"0";"0";"176400";"180000";"-3600"
"3204";"1658209";"2018-04-09";"88906";"2018-04-09";"H-852-17   OTROSI NRO 001";"56000";"54880";"1120";"0";"0";"0";"0";"0";"0";"0";"54880";"56000";"-1120"
"3205";"1658265";"2018-04-09";"88906";"2018-04-09";"H-852-17   OTROSI NRO 001";"56000";"54880";"1120";"0";"0";"0";"0";"0";"0";"0";"54880";"56000";"-1120"
"3206";"1658455";"2018-04-09";"88906";"2018-04-09";"H-852-17   OTROSI NRO 001";"56000";"54880";"1120";"0";"0";"0";"0";"0";"0";"0";"54880";"56000";"-1120"
"3207";"1658484";"2018-04-09";"88906";"2018-04-09";"H-852-17   OTROSI NRO 001";"70000";"68600";"1400";"0";"0";"0";"0";"0";"0";"0";"68600";"70000";"-1400"
"3208";"1658557";"2018-04-09";"88906";"2018-04-09";"H-852-17   OTROSI NRO 001";"46000";"45080";"920";"0";"0";"0";"0";"0";"0";"0";"45080";"46000";"-920"
"3209";"1658567";"2018-04-09";"88906";"2018-04-09";"H-852-17   OTROSI NRO 001";"70000";"68600";"1400";"0";"0";"0";"0";"0";"0";"0";"68600";"70000";"-1400"
"3210";"1658576";"2018-04-09";"88906";"2018-04-09";"H-852-17   OTROSI NRO 001";"46000";"45080";"920";"0";"0";"0";"0";"0";"0";"0";"45080";"46000";"-920"
"3211";"1658580";"2018-04-09";"88906";"2018-04-09";"H-852-17   OTROSI NRO 001";"46000";"45080";"920";"0";"0";"0";"0";"0";"0";"0";"45080";"46000";"-920"
"3212";"1658614";"2018-04-09";"88906";"2018-04-09";"H-852-17   OTROSI NRO 001";"70000";"68600";"1400";"0";"0";"0";"0";"0";"0";"0";"68600";"70000";"-1400"
"3213";"1658618";"2018-04-09";"88906";"2018-04-09";"H-852-17   OTROSI NRO 001";"46000";"45080";"920";"0";"0";"0";"0";"0";"0";"0";"45080";"46000";"-920"
"3214";"1658635";"2018-04-09";"88906";"2018-04-09";"H-852-17   OTROSI NRO 001";"46000";"45080";"920";"0";"0";"0";"0";"0";"0";"0";"45080";"46000";"-920"
"3215";"1658658";"2018-04-09";"88906";"2018-04-09";"H-852-17   OTROSI NRO 001";"56000";"54880";"1120";"0";"0";"0";"0";"0";"0";"0";"54880";"56000";"-1120"
"3216";"1658665";"2018-04-09";"88906";"2018-04-09";"H-852-17   OTROSI NRO 001";"46000";"45080";"920";"0";"0";"0";"0";"0";"0";"0";"45080";"46000";"-920"
"3217";"1658711";"2018-04-09";"88906";"2018-04-09";"H-852-17   OTROSI NRO 001";"46000";"45080";"920";"0";"0";"0";"0";"0";"0";"0";"45080";"46000";"-920"
"3218";"1658749";"2018-04-09";"88906";"2018-04-09";"H-852-17   OTROSI NRO 001";"46000";"45080";"920";"0";"0";"0";"0";"0";"0";"0";"45080";"46000";"-920"
"3219";"1658764";"2018-04-09";"88906";"2018-04-09";"H-852-17   OTROSI NRO 001";"35000";"34300";"700";"0";"0";"0";"0";"0";"0";"0";"34300";"35000";"-700"
"3220";"1658774";"2018-04-09";"88906";"2018-04-09";"H-852-17   OTROSI NRO 001";"56000";"54880";"1120";"0";"0";"0";"0";"0";"0";"0";"54880";"56000";"-1120"
"3221";"1659402";"2018-04-09";"88906";"2018-04-09";"H-852-17   OTROSI NRO 001";"46000";"45080";"920";"0";"0";"0";"0";"0";"0";"0";"45080";"46000";"-920"
"3222";"1660243";"2018-04-09";"88906";"2018-04-09";"H-852-17   OTROSI NRO 001";"46000";"45080";"920";"0";"0";"0";"0";"0";"0";"0";"45080";"46000";"-920"
"3223";"1660610";"2018-04-09";"88906";"2018-04-09";"H-852-17   OTROSI NRO 001";"70000";"68600";"1400";"0";"0";"0";"0";"0";"0";"0";"68600";"70000";"-1400"
"3224";"1660629";"2018-04-09";"88906";"2018-04-09";"H-852-17   OTROSI NRO 001";"35900";"35182";"718";"0";"0";"0";"0";"0";"0";"0";"35182";"35900";"-718"
"3225";"1660633";"2018-04-09";"88906";"2018-04-09";"H-852-17   OTROSI NRO 001";"46000";"45080";"920";"0";"0";"0";"0";"0";"0";"0";"45080";"46000";"-920"
"3226";"1660800";"2018-04-09";"88906";"2018-04-09";"H-852-17   OTROSI NRO 001";"46000";"45080";"920";"0";"0";"0";"0";"0";"0";"0";"45080";"46000";"-920"
"3227";"1660815";"2018-04-09";"88906";"2018-04-09";"H-852-17   OTROSI NRO 001";"470000";"460600";"9400";"0";"0";"0";"223000";"111500";"111500";"0";"349100";"247000";"102100"
"3228";"1634982";"2018-04-09";"89450";"2018-04-09";"H-852-17   OTROSI NRO 001";"370253";"362848";"7405";"0";"0";"0";"0";"0";"0";"0";"362848";"370253";"-7405"
"3229";"1647181";"2018-04-09";"89450";"2018-04-09";"H-852-17   OTROSI NRO 001";"21112";"20690";"422";"0";"0";"0";"0";"0";"0";"0";"20690";"21112";"-422"
"3230";"1659288";"2018-04-09";"89450";"2018-04-09";"H-852-17   OTROSI NRO 001";"1450000";"1421000";"29000";"0";"0";"0";"0";"0";"0";"0";"1421000";"1450000";"-29000"
"3231";"1660917";"2018-04-09";"89450";"2018-04-09";"H-852-17   OTROSI NRO 001";"692840";"678983";"13857";"0";"0";"0";"2840";"340";"2500";"0";"678643";"690000";"-11357"
"3232";"1663304";"2018-04-09";"89450";"2018-04-09";"H-852-17   OTROSI NRO 001";"300149";"294146";"6003";"0";"0";"0";"0";"0";"0";"0";"294146";"300149";"-6003"
"3233";"1663362";"2018-04-09";"89450";"2018-04-09";"H-852-17   OTROSI NRO 001";"300149";"294146";"6003";"0";"0";"0";"0";"0";"0";"0";"294146";"300149";"-6003"
"3234";"1664542";"2018-04-09";"89450";"2018-04-09";"H-852-17   OTROSI NRO 001";"230108";"225506";"4602";"0";"0";"0";"0";"0";"0";"0";"225506";"230108";"-4602"
"3235";"1665278";"2018-04-09";"89450";"2018-04-09";"H-852-17   OTROSI NRO 001";"300149";"294146";"6003";"0";"0";"0";"0";"0";"0";"0";"294146";"300149";"-6003"
"3236";"1665335";"2018-04-09";"89450";"2018-04-09";"H-852-17   OTROSI NRO 001";"770238";"754833";"15405";"0";"0";"0";"0";"0";"0";"0";"754833";"770238";"-15405"
"3237";"1665367";"2018-04-09";"89450";"2018-04-09";"H-852-17   OTROSI NRO 001";"300149";"294146";"6003";"0";"0";"0";"0";"0";"0";"0";"294146";"300149";"-6003"
"3238";"1666308";"2018-04-09";"89450";"2018-04-09";"H-852-17   OTROSI NRO 001";"410249";"446144";"-35895";"0";"0";"0";"0";"0";"0";"0";"446144";"410249";"35895"
"3239";"1667624";"2018-04-09";"89450";"2018-04-09";"H-852-17   OTROSI NRO 001";"470000";"460600";"9400";"0";"0";"0";"0";"0";"0";"0";"460600";"470000";"-9400"
"3240";"1667750";"2018-04-09";"89450";"2018-04-09";"H-852-17   OTROSI NRO 001";"56000";"54880";"1120";"0";"0";"0";"0";"0";"0";"0";"54880";"56000";"-1120"
"3241";"1667759";"2018-04-09";"89450";"2018-04-09";"H-852-17   OTROSI NRO 001";"70000";"68600";"1400";"0";"0";"0";"0";"0";"0";"0";"68600";"70000";"-1400"
"3242";"1667762";"2018-04-09";"89450";"2018-04-09";"H-852-17   OTROSI NRO 001";"46000";"45080";"920";"0";"0";"0";"0";"0";"0";"0";"45080";"46000";"-920"
"3243";"1667797";"2018-04-09";"89450";"2018-04-09";"H-852-17   OTROSI NRO 001";"56000";"54880";"1120";"0";"0";"0";"0";"0";"0";"0";"54880";"56000";"-1120"
"3244";"1667884";"2018-04-09";"89450";"2018-04-09";"H-852-17   OTROSI NRO 001";"46000";"45080";"920";"0";"0";"0";"0";"0";"0";"0";"45080";"46000";"-920"
"3245";"1667905";"2018-04-09";"89450";"2018-04-09";"H-852-17   OTROSI NRO 001";"70000";"68600";"1400";"0";"0";"0";"0";"0";"0";"0";"68600";"70000";"-1400"
"3246";"1668940";"2018-04-09";"89450";"2018-04-09";"H-852-17   OTROSI NRO 001";"311000";"304780";"6220";"0";"0";"0";"0";"0";"0";"0";"304780";"311000";"-6220"
"3247";"1669184";"2018-04-09";"89450";"2018-04-09";"H-852-17   OTROSI NRO 001";"194949";"191050";"3899";"0";"0";"0";"0";"0";"0";"0";"191050";"194949";"-3899"
"3248";"1657070";"2018-04-09";"89075";"2018-04-09";"H-852-17   OTROSI NRO 001";"133500";"130830";"2670";"0";"0";"0";"80300";"80300";"0";"0";"50530";"53200";"-2670"
"3249";"1662301";"2018-04-09";"89075";"2018-04-09";"H-852-17   OTROSI NRO 001";"46000";"45080";"920";"0";"0";"0";"0";"0";"0";"0";"45080";"46000";"-920"
"3250";"1662335";"2018-04-09";"89075";"2018-04-09";"H-852-17   OTROSI NRO 001";"56000";"54880";"1120";"0";"0";"0";"0";"0";"0";"0";"54880";"56000";"-1120"
"3251";"1662340";"2018-04-09";"89075";"2018-04-09";"H-852-17   OTROSI NRO 001";"70000";"68600";"1400";"0";"0";"0";"0";"0";"0";"0";"68600";"70000";"-1400"
"3252";"1662341";"2018-04-09";"89075";"2018-04-09";"H-852-17   OTROSI NRO 001";"46000";"45080";"920";"0";"0";"0";"0";"0";"0";"0";"45080";"46000";"-920"
"3253";"1662343";"2018-04-09";"89075";"2018-04-09";"H-852-17   OTROSI NRO 001";"70000";"68600";"1400";"0";"0";"0";"0";"0";"0";"0";"68600";"70000";"-1400"
"3254";"1662373";"2018-04-09";"89075";"2018-04-09";"H-852-17   OTROSI NRO 001";"46000";"45080";"920";"0";"0";"0";"0";"0";"0";"0";"45080";"46000";"-920"
"3255";"1662384";"2018-04-09";"89075";"2018-04-09";"H-852-17   OTROSI NRO 001";"70000";"68600";"1400";"0";"0";"0";"0";"0";"0";"0";"68600";"70000";"-1400"
"3256";"1662395";"2018-04-09";"89075";"2018-04-09";"H-852-17   OTROSI NRO 001";"46000";"45080";"920";"0";"0";"0";"0";"0";"0";"0";"45080";"46000";"-920"
"3257";"1662402";"2018-04-09";"89075";"2018-04-09";"H-852-17   OTROSI NRO 001";"46000";"45080";"920";"0";"0";"0";"0";"0";"0";"0";"45080";"46000";"-920"
"3258";"1662442";"2018-04-09";"89075";"2018-04-09";"H-852-17   OTROSI NRO 001";"56000";"54880";"1120";"0";"0";"0";"0";"0";"0";"0";"54880";"56000";"-1120"
"3259";"1662448";"2018-04-09";"89075";"2018-04-09";"H-852-17   OTROSI NRO 001";"56000";"54880";"1120";"0";"0";"0";"0";"0";"0";"0";"54880";"56000";"-1120"
"3260";"1662452";"2018-04-09";"89075";"2018-04-09";"H-852-17   OTROSI NRO 001";"56000";"54880";"1120";"0";"0";"0";"0";"0";"0";"0";"54880";"56000";"-1120"
"3261";"1662486";"2018-04-09";"89075";"2018-04-09";"H-852-17   OTROSI NRO 001";"46000";"45080";"920";"0";"0";"0";"0";"0";"0";"0";"45080";"46000";"-920"
"3262";"1662517";"2018-04-09";"89075";"2018-04-09";"H-852-17   OTROSI NRO 001";"70000";"68600";"1400";"0";"0";"0";"0";"0";"0";"0";"68600";"70000";"-1400"
"3263";"1662560";"2018-04-09";"89075";"2018-04-09";"H-852-17   OTROSI NRO 001";"46000";"45080";"920";"0";"0";"0";"0";"0";"0";"0";"45080";"46000";"-920"
"3264";"1662562";"2018-04-09";"89075";"2018-04-09";"H-852-17   OTROSI NRO 001";"46000";"45080";"920";"0";"0";"0";"0";"0";"0";"0";"45080";"46000";"-920"
"3265";"1662575";"2018-04-09";"89075";"2018-04-09";"H-852-17   OTROSI NRO 001";"56000";"54880";"1120";"0";"0";"0";"0";"0";"0";"0";"54880";"56000";"-1120"
"3266";"1662609";"2018-04-09";"89075";"2018-04-09";"H-852-17   OTROSI NRO 001";"46000";"45080";"920";"0";"0";"0";"0";"0";"0";"0";"45080";"46000";"-920"
"3267";"1662618";"2018-04-09";"89075";"2018-04-09";"H-852-17   OTROSI NRO 001";"46000";"45080";"920";"0";"0";"0";"0";"0";"0";"0";"45080";"46000";"-920"
"3268";"1662752";"2018-04-09";"89075";"2018-04-09";"H-852-17   OTROSI NRO 001";"311000";"304780";"6220";"0";"0";"0";"0";"0";"0";"0";"304780";"311000";"-6220"
"3269";"1662882";"2018-04-09";"89075";"2018-04-09";"H-852-17   OTROSI NRO 001";"70000";"68600";"1400";"0";"0";"0";"0";"0";"0";"0";"68600";"70000";"-1400"
"3270";"1662893";"2018-04-09";"89075";"2018-04-09";"H-852-17   OTROSI NRO 001";"56000";"54880";"1120";"0";"0";"0";"0";"0";"0";"0";"54880";"56000";"-1120"
"3271";"1662955";"2018-04-09";"89075";"2018-04-09";"H-852-17   OTROSI NRO 001";"35000";"34300";"700";"0";"0";"0";"0";"0";"0";"0";"34300";"35000";"-700"
"3272";"1662996";"2018-04-09";"89075";"2018-04-09";"H-852-17   OTROSI NRO 001";"46000";"45080";"920";"0";"0";"0";"0";"0";"0";"0";"45080";"46000";"-920"
"3273";"1662997";"2018-04-09";"89075";"2018-04-09";"H-852-17   OTROSI NRO 001";"35000";"34300";"700";"0";"0";"0";"0";"0";"0";"0";"34300";"35000";"-700"
"3274";"1663018";"2018-04-09";"89075";"2018-04-09";"H-852-17   OTROSI NRO 001";"35000";"34300";"700";"0";"0";"0";"0";"0";"0";"0";"34300";"35000";"-700"
"3275";"1663027";"2018-04-09";"89075";"2018-04-09";"H-852-17   OTROSI NRO 001";"46000";"45080";"920";"0";"0";"0";"0";"0";"0";"0";"45080";"46000";"-920"
"3276";"1663065";"2018-04-09";"89075";"2018-04-09";"H-852-17   OTROSI NRO 001";"46000";"45080";"920";"0";"0";"0";"0";"0";"0";"0";"45080";"46000";"-920"
"3277";"1663073";"2018-04-09";"89075";"2018-04-09";"H-852-17   OTROSI NRO 001";"35000";"34300";"700";"0";"0";"0";"0";"0";"0";"0";"34300";"35000";"-700"
"3278";"1663092";"2018-04-09";"89075";"2018-04-09";"H-852-17   OTROSI NRO 001";"46000";"45080";"920";"0";"0";"0";"0";"0";"0";"0";"45080";"46000";"-920"
"3279";"1663099";"2018-04-09";"89075";"2018-04-09";"H-852-17   OTROSI NRO 001";"56000";"54880";"1120";"0";"0";"0";"0";"0";"0";"0";"54880";"56000";"-1120"
"3280";"1663113";"2018-04-09";"89075";"2018-04-09";"H-852-17   OTROSI NRO 001";"46000";"45080";"920";"0";"0";"0";"0";"0";"0";"0";"45080";"46000";"-920"
"3281";"1611658";"2018-04-09";"89334";"2018-04-09";"H-852-17   OTROSI NRO 001";"46000";"45080";"920";"0";"0";"0";"0";"0";"0";"0";"45080";"46000";"-920"
"3282";"1612264";"2018-04-09";"89334";"2018-04-09";"H-852-17   OTROSI NRO 001";"90000";"88200";"1800";"0";"0";"0";"0";"0";"0";"0";"88200";"90000";"-1800"
"3283";"1620485";"2018-04-09";"89334";"2018-04-09";"H-852-17   OTROSI NRO 001";"90000";"88200";"1800";"0";"0";"0";"0";"0";"0";"0";"88200";"90000";"-1800"
"3284";"1624736";"2018-04-09";"89334";"2018-04-09";"H-852-17   OTROSI NRO 001";"46000";"45080";"920";"0";"0";"0";"0";"0";"0";"0";"45080";"46000";"-920"
"3285";"1624740";"2018-04-09";"89334";"2018-04-09";"H-852-17   OTROSI NRO 001";"46000";"45080";"920";"0";"0";"0";"0";"0";"0";"0";"45080";"46000";"-920"
"3286";"1627504";"2018-04-09";"89334";"2018-04-09";"H-852-17   OTROSI NRO 001";"46000";"45080";"920";"0";"0";"0";"0";"0";"0";"0";"45080";"46000";"-920"
"3287";"1632161";"2018-04-09";"89334";"2018-04-09";"H-852-17   OTROSI NRO 001";"274200";"268716";"5484";"0";"0";"0";"0";"0";"0";"0";"268716";"274200";"-5484"
"3288";"1633536";"2018-04-09";"89334";"2018-04-09";"H-852-17   OTROSI NRO 001";"1720181";"1685777";"34404";"0";"0";"0";"125181";"125181";"0";"0";"1560596";"1595000";"-34404"
"3289";"1639198";"2018-04-09";"89334";"2018-04-09";"H-852-17   OTROSI NRO 001";"191400";"187572";"3828";"0";"0";"0";"0";"0";"0";"0";"187572";"191400";"-3828"
"3290";"1640769";"2018-04-09";"89334";"2018-04-09";"H-852-17   OTROSI NRO 001";"311000";"304780";"6220";"0";"0";"0";"0";"0";"0";"0";"304780";"311000";"-6220"
"3291";"1663425";"2018-04-09";"89200";"2018-04-09";"H-852-17   OTROSI NRO 001";"56000";"54880";"1120";"0";"0";"0";"0";"0";"0";"0";"54880";"56000";"-1120"
"3292";"1663426";"2018-04-09";"89200";"2018-04-09";"H-852-17   OTROSI NRO 001";"112201";"109957";"2244";"0";"0";"0";"0";"0";"0";"0";"109957";"112201";"-2244"
"3293";"1663452";"2018-04-09";"89200";"2018-04-09";"H-852-17   OTROSI NRO 001";"46000";"45080";"920";"0";"0";"0";"0";"0";"0";"0";"45080";"46000";"-920"
"3294";"1663466";"2018-04-09";"89200";"2018-04-09";"H-852-17   OTROSI NRO 001";"46000";"45080";"920";"0";"0";"0";"0";"0";"0";"0";"45080";"46000";"-920"
"3295";"1663468";"2018-04-09";"89200";"2018-04-09";"H-852-17   OTROSI NRO 001";"46000";"45080";"920";"0";"0";"0";"0";"0";"0";"0";"45080";"46000";"-920"
"3296";"1663509";"2018-04-09";"89200";"2018-04-09";"H-852-17   OTROSI NRO 001";"56000";"54880";"1120";"0";"0";"0";"0";"0";"0";"0";"54880";"56000";"-1120"
"3297";"1663523";"2018-04-09";"89200";"2018-04-09";"H-852-17   OTROSI NRO 001";"56000";"54880";"1120";"0";"0";"0";"0";"0";"0";"0";"54880";"56000";"-1120"
"3298";"1663528";"2018-04-09";"89200";"2018-04-09";"H-852-17   OTROSI NRO 001";"46000";"45080";"920";"0";"0";"0";"0";"0";"0";"0";"45080";"46000";"-920"
"3299";"1663535";"2018-04-09";"89200";"2018-04-09";"H-852-17   OTROSI NRO 001";"70000";"68600";"1400";"0";"0";"0";"0";"0";"0";"0";"68600";"70000";"-1400"
"3300";"1663543";"2018-04-09";"89200";"2018-04-09";"H-852-17   OTROSI NRO 001";"46000";"45080";"920";"0";"0";"0";"0";"0";"0";"0";"45080";"46000";"-920"
"3301";"1663563";"2018-04-09";"89200";"2018-04-09";"H-852-17   OTROSI NRO 001";"56000";"54880";"1120";"0";"0";"0";"0";"0";"0";"0";"54880";"56000";"-1120"
"3302";"1663588";"2018-04-09";"89200";"2018-04-09";"H-852-17   OTROSI NRO 001";"46000";"45080";"920";"0";"0";"0";"0";"0";"0";"0";"45080";"46000";"-920"
"3303";"1663728";"2018-04-09";"89200";"2018-04-09";"H-852-17   OTROSI NRO 001";"46000";"45080";"920";"0";"0";"0";"0";"0";"0";"0";"45080";"46000";"-920"
"3304";"1663733";"2018-04-09";"89200";"2018-04-09";"H-852-17   OTROSI NRO 001";"70000";"68600";"1400";"0";"0";"0";"0";"0";"0";"0";"68600";"70000";"-1400"
"3305";"1663734";"2018-04-09";"89200";"2018-04-09";"H-852-17   OTROSI NRO 001";"46000";"45080";"920";"0";"0";"0";"0";"0";"0";"0";"45080";"46000";"-920"
"3306";"1663744";"2018-04-09";"89200";"2018-04-09";"H-852-17   OTROSI NRO 001";"46000";"45080";"920";"0";"0";"0";"0";"0";"0";"0";"45080";"46000";"-920"
"3307";"1663746";"2018-04-09";"89200";"2018-04-09";"H-852-17   OTROSI NRO 001";"46000";"45080";"920";"0";"0";"0";"0";"0";"0";"0";"45080";"46000";"-920"
"3308";"1663819";"2018-04-09";"89200";"2018-04-09";"H-852-17   OTROSI NRO 001";"46000";"45080";"920";"0";"0";"0";"0";"0";"0";"0";"45080";"46000";"-920"
"3309";"1663827";"2018-04-09";"89200";"2018-04-09";"H-852-17   OTROSI NRO 001";"46000";"45080";"920";"0";"0";"0";"0";"0";"0";"0";"45080";"46000";"-920"
"3310";"1663837";"2018-04-09";"89200";"2018-04-09";"H-852-17   OTROSI NRO 001";"46000";"45080";"920";"0";"0";"0";"0";"0";"0";"0";"45080";"46000";"-920"
"3311";"1663841";"2018-04-09";"89200";"2018-04-09";"H-852-17   OTROSI NRO 001";"46000";"45080";"920";"0";"0";"0";"0";"0";"0";"0";"45080";"46000";"-920"
"3312";"1663958";"2018-04-09";"89200";"2018-04-09";"H-852-17   OTROSI NRO 001";"56000";"54880";"1120";"0";"0";"0";"0";"0";"0";"0";"54880";"56000";"-1120"
"3313";"1663963";"2018-04-09";"89200";"2018-04-09";"H-852-17   OTROSI NRO 001";"70000";"68600";"1400";"0";"0";"0";"0";"0";"0";"0";"68600";"70000";"-1400"
"3314";"1663982";"2018-04-09";"89200";"2018-04-09";"H-852-17   OTROSI NRO 001";"46000";"45080";"920";"0";"0";"0";"0";"0";"0";"0";"45080";"46000";"-920"
"3315";"1663996";"2018-04-09";"89200";"2018-04-09";"H-852-17   OTROSI NRO 001";"35000";"34300";"700";"0";"0";"0";"0";"0";"0";"0";"34300";"35000";"-700"
"3316";"1664008";"2018-04-09";"89200";"2018-04-09";"H-852-17   OTROSI NRO 001";"311000";"304780";"6220";"0";"0";"0";"0";"0";"0";"0";"304780";"311000";"-6220"
"3317";"1664039";"2018-04-09";"89200";"2018-04-09";"H-852-17   OTROSI NRO 001";"46000";"45080";"920";"0";"0";"0";"0";"0";"0";"0";"45080";"46000";"-920"
"3318";"1664117";"2018-04-09";"89200";"2018-04-09";"H-852-17   OTROSI NRO 001";"56000";"54880";"1120";"0";"0";"0";"0";"0";"0";"0";"54880";"56000";"-1120"
"3319";"1664377";"2018-04-09";"89200";"2018-04-09";"H-852-17   OTROSI NRO 001";"46000";"45080";"920";"0";"0";"0";"0";"0";"0";"0";"45080";"46000";"-920"
"3320";"1664418";"2018-04-09";"89200";"2018-04-09";"H-852-17   OTROSI NRO 001";"46000";"45080";"920";"0";"0";"0";"0";"0";"0";"0";"45080";"46000";"-920"
"3321";"1664440";"2018-04-09";"89200";"2018-04-09";"H-852-17   OTROSI NRO 001";"46000";"45080";"920";"0";"0";"0";"0";"0";"0";"0";"45080";"46000";"-920"
"3322";"1664483";"2018-04-09";"89200";"2018-04-09";"H-852-17   OTROSI NRO 001";"274200";"268716";"5484";"0";"0";"0";"0";"0";"0";"0";"268716";"274200";"-5484"
"3323";"1665240";"2018-04-09";"89200";"2018-04-09";"H-852-17   OTROSI NRO 001";"46000";"45080";"920";"0";"0";"0";"0";"0";"0";"0";"45080";"46000";"-920"
"3324";"1655219";"2018-04-09";"88909";"2018-04-09";"H-852-17   OTROSI NRO 001";"274200";"268716";"5484";"0";"0";"0";"0";"0";"0";"0";"268716";"274200";"-5484"
"3325";"1658125";"2018-04-09";"88909";"2018-04-09";"H-852-17   OTROSI NRO 001";"17700";"17346";"354";"0";"0";"0";"0";"0";"0";"0";"17346";"17700";"-354"
"3326";"1658548";"2018-04-09";"88909";"2018-04-09";"H-852-17   OTROSI NRO 001";"35000";"34300";"700";"0";"0";"0";"0";"0";"0";"0";"34300";"35000";"-700"
"3327";"1658605";"2018-04-09";"88909";"2018-04-09";"H-852-17   OTROSI NRO 001";"46000";"45080";"920";"0";"0";"0";"0";"0";"0";"0";"45080";"46000";"-920"
"3328";"1658607";"2018-04-09";"88909";"2018-04-09";"H-852-17   OTROSI NRO 001";"70000";"68600";"1400";"0";"0";"0";"0";"0";"0";"0";"68600";"70000";"-1400"
"3329";"1659033";"2018-04-09";"88909";"2018-04-09";"H-852-17   OTROSI NRO 001";"329315";"322729";"6586";"0";"0";"0";"0";"0";"0";"0";"322729";"329315";"-6586"
"3330";"1659152";"2018-04-09";"88909";"2018-04-09";"H-852-17   OTROSI NRO 001";"56000";"54880";"1120";"0";"0";"0";"0";"0";"0";"0";"54880";"56000";"-1120"
"3331";"1659160";"2018-04-09";"88909";"2018-04-09";"H-852-17   OTROSI NRO 001";"56000";"54880";"1120";"0";"0";"0";"0";"0";"0";"0";"54880";"56000";"-1120"
"3332";"1659161";"2018-04-09";"88909";"2018-04-09";"H-852-17   OTROSI NRO 001";"46000";"45080";"920";"0";"0";"0";"0";"0";"0";"0";"45080";"46000";"-920"
"3333";"1659179";"2018-04-09";"88909";"2018-04-09";"H-852-17   OTROSI NRO 001";"35000";"34300";"700";"0";"0";"0";"0";"0";"0";"0";"34300";"35000";"-700"
"3334";"1659181";"2018-04-09";"88909";"2018-04-09";"H-852-17   OTROSI NRO 001";"46000";"45080";"920";"0";"0";"0";"0";"0";"0";"0";"45080";"46000";"-920"
"3335";"1659184";"2018-04-09";"88909";"2018-04-09";"H-852-17   OTROSI NRO 001";"46000";"45080";"920";"0";"0";"0";"0";"0";"0";"0";"45080";"46000";"-920"
"3336";"1659217";"2018-04-09";"88909";"2018-04-09";"H-852-17   OTROSI NRO 001";"46000";"45080";"920";"0";"0";"0";"0";"0";"0";"0";"45080";"46000";"-920"
"3337";"1659220";"2018-04-09";"88909";"2018-04-09";"H-852-17   OTROSI NRO 001";"56000";"54880";"1120";"0";"0";"0";"0";"0";"0";"0";"54880";"56000";"-1120"
"3338";"1659232";"2018-04-09";"88909";"2018-04-09";"H-852-17   OTROSI NRO 001";"46000";"45080";"920";"0";"0";"0";"0";"0";"0";"0";"45080";"46000";"-920"
"3339";"1659233";"2018-04-09";"88909";"2018-04-09";"H-852-17   OTROSI NRO 001";"70000";"68600";"1400";"0";"0";"0";"0";"0";"0";"0";"68600";"70000";"-1400"
"3340";"1659236";"2018-04-09";"88909";"2018-04-09";"H-852-17   OTROSI NRO 001";"56000";"54880";"1120";"0";"0";"0";"0";"0";"0";"0";"54880";"56000";"-1120"
"3341";"1659246";"2018-04-09";"88909";"2018-04-09";"H-852-17   OTROSI NRO 001";"46000";"45080";"920";"0";"0";"0";"0";"0";"0";"0";"45080";"46000";"-920"
"3342";"1659250";"2018-04-09";"88909";"2018-04-09";"H-852-17   OTROSI NRO 001";"35000";"34300";"700";"0";"0";"0";"0";"0";"0";"0";"34300";"35000";"-700"
"3343";"1659264";"2018-04-09";"88909";"2018-04-09";"H-852-17   OTROSI NRO 001";"46000";"45080";"920";"0";"0";"0";"0";"0";"0";"0";"45080";"46000";"-920"
"3344";"1659309";"2018-04-09";"88909";"2018-04-09";"H-852-17   OTROSI NRO 001";"46000";"45080";"920";"0";"0";"0";"0";"0";"0";"0";"45080";"46000";"-920"
"3345";"1659315";"2018-04-09";"88909";"2018-04-09";"H-852-17   OTROSI NRO 001";"46000";"45080";"920";"0";"0";"0";"0";"0";"0";"0";"45080";"46000";"-920"
"3346";"1659364";"2018-04-09";"88909";"2018-04-09";"H-852-17   OTROSI NRO 001";"46000";"45080";"920";"0";"0";"0";"0";"0";"0";"0";"45080";"46000";"-920"
"3347";"1659472";"2018-04-09";"88909";"2018-04-09";"H-852-17   OTROSI NRO 001";"56000";"54880";"1120";"0";"0";"0";"0";"0";"0";"0";"54880";"56000";"-1120"
"3348";"1659476";"2018-04-09";"88909";"2018-04-09";"H-852-17   OTROSI NRO 001";"70000";"68600";"1400";"0";"0";"0";"0";"0";"0";"0";"68600";"70000";"-1400"
"3349";"1659788";"2018-04-09";"88909";"2018-04-09";"H-852-17   OTROSI NRO 001";"24445";"23956";"489";"0";"0";"0";"0";"0";"0";"0";"23956";"24445";"-489"
"3350";"1659936";"2018-04-09";"88909";"2018-04-09";"H-852-17   OTROSI NRO 001";"46000";"45080";"920";"0";"0";"0";"0";"0";"0";"0";"45080";"46000";"-920"
"3351";"1659939";"2018-04-09";"88909";"2018-04-09";"H-852-17   OTROSI NRO 001";"46000";"45080";"920";"0";"0";"0";"0";"0";"0";"0";"45080";"46000";"-920"
"3352";"1659940";"2018-04-09";"88909";"2018-04-09";"H-852-17   OTROSI NRO 001";"56000";"54880";"1120";"0";"0";"0";"0";"0";"0";"0";"54880";"56000";"-1120"
"3353";"1659941";"2018-04-09";"88909";"2018-04-09";"H-852-17   OTROSI NRO 001";"56000";"54880";"1120";"0";"0";"0";"0";"0";"0";"0";"54880";"56000";"-1120"
"3354";"1659944";"2018-04-09";"88909";"2018-04-09";"H-852-17   OTROSI NRO 001";"56000";"54880";"1120";"0";"0";"0";"0";"0";"0";"0";"54880";"56000";"-1120"
"3355";"1659945";"2018-04-09";"88909";"2018-04-09";"H-852-17   OTROSI NRO 001";"46000";"45080";"920";"0";"0";"0";"0";"0";"0";"0";"45080";"46000";"-920"
"3356";"1659992";"2018-04-09";"88909";"2018-04-09";"H-852-17   OTROSI NRO 001";"46000";"45080";"920";"0";"0";"0";"0";"0";"0";"0";"45080";"46000";"-920"
"3357";"1648710";"2018-04-09";"88907";"2018-04-09";"H-852-17   OTROSI NRO 001";"274200";"268716";"5484";"0";"0";"0";"0";"0";"0";"0";"268716";"274200";"-5484"
"3358";"1648801";"2018-04-09";"88907";"2018-04-09";"H-852-17   OTROSI NRO 001";"452699";"443645";"9054";"0";"0";"0";"0";"0";"0";"0";"443645";"452699";"-9054"
"3359";"1651666";"2018-04-09";"88907";"2018-04-09";"H-852-17   OTROSI NRO 001";"274200";"268716";"5484";"0";"0";"0";"0";"0";"0";"0";"268716";"274200";"-5484"
"3360";"1651722";"2018-04-09";"88907";"2018-04-09";"H-852-17   OTROSI NRO 001";"548400";"537432";"10968";"0";"0";"0";"0";"0";"0";"0";"537432";"548400";"-10968"
"3361";"1651792";"2018-04-09";"88907";"2018-04-09";"H-852-17   OTROSI NRO 001";"147500";"144550";"2950";"0";"0";"0";"0";"0";"0";"0";"144550";"147500";"-2950"
"3362";"1655648";"2018-04-09";"88907";"2018-04-09";"H-852-17   OTROSI NRO 001";"274200";"268716";"5484";"0";"0";"0";"0";"0";"0";"0";"268716";"274200";"-5484"
"3363";"1655725";"2018-04-09";"88907";"2018-04-09";"H-852-17   OTROSI NRO 001";"259932";"254733";"5199";"0";"0";"0";"0";"0";"0";"0";"254733";"259932";"-5199"
"3364";"1657259";"2018-04-09";"88907";"2018-04-09";"H-852-17   OTROSI NRO 001";"14594";"14302";"292";"0";"0";"0";"0";"0";"0";"0";"14302";"14594";"-292"
"3365";"1657336";"2018-04-09";"88907";"2018-04-09";"H-852-17   OTROSI NRO 001";"56000";"54880";"1120";"0";"0";"0";"0";"0";"0";"0";"54880";"56000";"-1120"
"3366";"1657342";"2018-04-09";"88907";"2018-04-09";"H-852-17   OTROSI NRO 001";"56000";"54880";"1120";"0";"0";"0";"0";"0";"0";"0";"54880";"56000";"-1120"
"3367";"1657346";"2018-04-09";"88907";"2018-04-09";"H-852-17   OTROSI NRO 001";"46000";"45080";"920";"0";"0";"0";"0";"0";"0";"0";"45080";"46000";"-920"
"3368";"1657504";"2018-04-09";"88907";"2018-04-09";"H-852-17   OTROSI NRO 001";"46000";"45080";"920";"0";"0";"0";"0";"0";"0";"0";"45080";"46000";"-920"
"3369";"1657529";"2018-04-09";"88907";"2018-04-09";"H-852-17   OTROSI NRO 001";"35000";"34300";"700";"0";"0";"0";"0";"0";"0";"0";"34300";"35000";"-700"
"3370";"1657539";"2018-04-09";"88907";"2018-04-09";"H-852-17   OTROSI NRO 001";"35000";"34300";"700";"0";"0";"0";"0";"0";"0";"0";"34300";"35000";"-700"
"3371";"1657582";"2018-04-09";"88907";"2018-04-09";"H-852-17   OTROSI NRO 001";"46000";"45080";"920";"0";"0";"0";"0";"0";"0";"0";"45080";"46000";"-920"
"3372";"1657630";"2018-04-09";"88907";"2018-04-09";"H-852-17   OTROSI NRO 001";"56000";"54880";"1120";"0";"0";"0";"0";"0";"0";"0";"54880";"56000";"-1120"
"3373";"1657642";"2018-04-09";"88907";"2018-04-09";"H-852-17   OTROSI NRO 001";"70000";"68600";"1400";"0";"0";"0";"0";"0";"0";"0";"68600";"70000";"-1400"
"3374";"1657652";"2018-04-09";"88907";"2018-04-09";"H-852-17   OTROSI NRO 001";"56000";"54880";"1120";"0";"0";"0";"0";"0";"0";"0";"54880";"56000";"-1120"
"3375";"1657654";"2018-04-09";"88907";"2018-04-09";"H-852-17   OTROSI NRO 001";"46000";"45080";"920";"0";"0";"0";"0";"0";"0";"0";"45080";"46000";"-920"
"3376";"1657680";"2018-04-09";"88907";"2018-04-09";"H-852-17   OTROSI NRO 001";"46000";"45080";"920";"0";"0";"0";"0";"0";"0";"0";"45080";"46000";"-920"
"3377";"1657893";"2018-04-09";"88907";"2018-04-09";"H-852-17   OTROSI NRO 001";"274200";"268716";"5484";"0";"0";"0";"0";"0";"0";"0";"268716";"274200";"-5484"
"3378";"1657926";"2018-04-09";"88907";"2018-04-09";"H-852-17   OTROSI NRO 001";"56000";"54880";"1120";"0";"0";"0";"0";"0";"0";"0";"54880";"56000";"-1120"
"3379";"1657949";"2018-04-09";"88907";"2018-04-09";"H-852-17   OTROSI NRO 001";"46000";"45080";"920";"0";"0";"0";"0";"0";"0";"0";"45080";"46000";"-920"
"3380";"1657963";"2018-04-09";"88907";"2018-04-09";"H-852-17   OTROSI NRO 001";"46000";"45080";"920";"0";"0";"0";"0";"0";"0";"0";"45080";"46000";"-920"
"3381";"1657967";"2018-04-09";"88907";"2018-04-09";"H-852-17   OTROSI NRO 001";"46000";"45080";"920";"0";"0";"0";"0";"0";"0";"0";"45080";"46000";"-920"
"3382";"1657973";"2018-04-09";"88907";"2018-04-09";"H-852-17   OTROSI NRO 001";"46000";"45080";"920";"0";"0";"0";"0";"0";"0";"0";"45080";"46000";"-920"
"3383";"1657974";"2018-04-09";"88907";"2018-04-09";"H-852-17   OTROSI NRO 001";"46000";"45080";"920";"0";"0";"0";"0";"0";"0";"0";"45080";"46000";"-920"
"3384";"1657994";"2018-04-09";"88907";"2018-04-09";"H-852-17   OTROSI NRO 001";"46000";"45080";"920";"0";"0";"0";"0";"0";"0";"0";"45080";"46000";"-920"
"3385";"1658005";"2018-04-09";"88907";"2018-04-09";"H-852-17   OTROSI NRO 001";"70000";"68600";"1400";"0";"0";"0";"0";"0";"0";"0";"68600";"70000";"-1400"
"3386";"1658044";"2018-04-09";"88907";"2018-04-09";"H-852-17   OTROSI NRO 001";"46000";"45080";"920";"0";"0";"0";"0";"0";"0";"0";"45080";"46000";"-920"
"3387";"1658227";"2018-04-09";"88907";"2018-04-09";"H-852-17   OTROSI NRO 001";"46000";"45080";"920";"0";"0";"0";"0";"0";"0";"0";"45080";"46000";"-920"
"3388";"1658513";"2018-04-09";"88907";"2018-04-09";"H-852-17   OTROSI NRO 001";"46000";"45080";"920";"0";"0";"0";"0";"0";"0";"0";"45080";"46000";"-920"
"3389";"1658538";"2018-04-09";"88907";"2018-04-09";"H-852-17   OTROSI NRO 001";"46000";"45080";"920";"0";"0";"0";"0";"0";"0";"0";"45080";"46000";"-920"
"3390";"1658613";"2018-04-09";"88907";"2018-04-09";"H-852-17   OTROSI NRO 001";"56000";"54880";"1120";"0";"0";"0";"0";"0";"0";"0";"54880";"56000";"-1120"
"3391";"1658633";"2018-04-09";"88907";"2018-04-09";"H-852-17   OTROSI NRO 001";"35000";"34300";"700";"0";"0";"0";"0";"0";"0";"0";"34300";"35000";"-700"
"3392";"1656743";"2018-04-09";"88912";"2018-04-09";"H-852-17   OTROSI NRO 001";"46000";"45080";"920";"0";"0";"0";"0";"0";"0";"0";"45080";"46000";"-920"
"3393";"1656756";"2018-04-09";"88912";"2018-04-09";"H-852-17   OTROSI NRO 001";"46000";"45080";"920";"0";"0";"0";"0";"0";"0";"0";"45080";"46000";"-920"
"3394";"1648035";"2018-04-09";"88915";"2018-04-09";"H-852-17   OTROSI NRO 001";"400000";"392000";"8000";"0";"0";"0";"0";"0";"0";"0";"392000";"400000";"-8000"
"3395";"1650490";"2018-04-09";"88915";"2018-04-09";"H-852-17   OTROSI NRO 001";"111600";"109368";"2232";"0";"0";"0";"38800";"0";"38800";"0";"109368";"72800";"36568"
"3396";"1654705";"2018-04-09";"88915";"2018-04-09";"H-852-17   OTROSI NRO 001";"508950";"498771";"10179";"0";"0";"0";"279000";"279000";"0";"0";"219771";"229950";"-10179"
"3397";"1654852";"2018-04-09";"88915";"2018-04-09";"H-852-17   OTROSI NRO 001";"46000";"45080";"920";"0";"0";"0";"0";"0";"0";"0";"45080";"46000";"-920"
"3398";"1654868";"2018-04-09";"88915";"2018-04-09";"H-852-17   OTROSI NRO 001";"90000";"88200";"1800";"0";"0";"0";"0";"0";"0";"0";"88200";"90000";"-1800"
"3399";"1655074";"2018-04-09";"88915";"2018-04-09";"H-852-17   OTROSI NRO 001";"973800";"954324";"19476";"0";"0";"0";"223000";"111500";"111500";"0";"842824";"750800";"92024"
"3400";"1655210";"2018-04-09";"88915";"2018-04-09";"H-852-17   OTROSI NRO 001";"46000";"45080";"920";"0";"0";"0";"0";"0";"0";"0";"45080";"46000";"-920"
"3401";"1655524";"2018-04-09";"88915";"2018-04-09";"H-852-17   OTROSI NRO 001";"56000";"54880";"1120";"0";"0";"0";"0";"0";"0";"0";"54880";"56000";"-1120"
"3402";"1655545";"2018-04-09";"88915";"2018-04-09";"H-852-17   OTROSI NRO 001";"46000";"45080";"920";"0";"0";"0";"0";"0";"0";"0";"45080";"46000";"-920"
"3403";"1655580";"2018-04-09";"88915";"2018-04-09";"H-852-17   OTROSI NRO 001";"46000";"45080";"920";"0";"0";"0";"0";"0";"0";"0";"45080";"46000";"-920"
"3404";"1655591";"2018-04-09";"88915";"2018-04-09";"H-852-17   OTROSI NRO 001";"70000";"68600";"1400";"0";"0";"0";"0";"0";"0";"0";"68600";"70000";"-1400"
"3405";"1655596";"2018-04-09";"88915";"2018-04-09";"H-852-17   OTROSI NRO 001";"56000";"54880";"1120";"0";"0";"0";"0";"0";"0";"0";"54880";"56000";"-1120"
"3406";"1655668";"2018-04-09";"88915";"2018-04-09";"H-852-17   OTROSI NRO 001";"70000";"68600";"1400";"0";"0";"0";"0";"0";"0";"0";"68600";"70000";"-1400"
"3407";"1655683";"2018-04-09";"88915";"2018-04-09";"H-852-17   OTROSI NRO 001";"46000";"45080";"920";"0";"0";"0";"0";"0";"0";"0";"45080";"46000";"-920"
"3408";"1655702";"2018-04-09";"88915";"2018-04-09";"H-852-17   OTROSI NRO 001";"46000";"45080";"920";"0";"0";"0";"0";"0";"0";"0";"45080";"46000";"-920"
"3409";"1655707";"2018-04-09";"88915";"2018-04-09";"H-852-17   OTROSI NRO 001";"56000";"54880";"1120";"0";"0";"0";"0";"0";"0";"0";"54880";"56000";"-1120"
"3410";"1655722";"2018-04-09";"88915";"2018-04-09";"H-852-17   OTROSI NRO 001";"70000";"68600";"1400";"0";"0";"0";"0";"0";"0";"0";"68600";"70000";"-1400"
"3411";"1655875";"2018-04-09";"88915";"2018-04-09";"H-852-17   OTROSI NRO 001";"46000";"45080";"920";"0";"0";"0";"0";"0";"0";"0";"45080";"46000";"-920"
"3412";"1655880";"2018-04-09";"88915";"2018-04-09";"H-852-17   OTROSI NRO 001";"90000";"88200";"1800";"0";"0";"0";"0";"0";"0";"0";"88200";"90000";"-1800"
"3413";"1655899";"2018-04-09";"88915";"2018-04-09";"H-852-17   OTROSI NRO 001";"46000";"45080";"920";"0";"0";"0";"0";"0";"0";"0";"45080";"46000";"-920"
"3414";"1655914";"2018-04-09";"88915";"2018-04-09";"H-852-17   OTROSI NRO 001";"56000";"54880";"1120";"0";"0";"0";"0";"0";"0";"0";"54880";"56000";"-1120"
"3415";"1656259";"2018-04-09";"88915";"2018-04-09";"H-852-17   OTROSI NRO 001";"46000";"45080";"920";"0";"0";"0";"0";"0";"0";"0";"45080";"46000";"-920"
"3416";"1659077";"2018-04-09";"88915";"2018-04-09";"H-852-17   OTROSI NRO 001";"559379";"548191";"11188";"0";"0";"0";"178200";"132650";"45550";"0";"415541";"426729";"-11188"
"3417";"1659721";"2018-04-09";"88915";"2018-04-09";"H-852-17   OTROSI NRO 001";"70000";"68600";"1400";"0";"0";"0";"0";"0";"0";"0";"68600";"70000";"-1400"
"3418";"1660421";"2018-04-09";"88915";"2018-04-09";"H-852-17   OTROSI NRO 001";"46000";"45080";"920";"0";"0";"0";"0";"0";"0";"0";"45080";"46000";"-920"
"3419";"1660792";"2018-04-09";"88915";"2018-04-09";"H-852-17   OTROSI NRO 001";"374805";"367309";"7496";"0";"0";"0";"37411";"19811";"17600";"0";"347498";"337394";"10104"
"3420";"1660980";"2018-04-09";"88915";"2018-04-09";"H-852-17   OTROSI NRO 001";"46000";"45080";"920";"0";"0";"0";"0";"0";"0";"0";"45080";"46000";"-920"
"3421";"1661006";"2018-04-09";"88915";"2018-04-09";"H-852-17   OTROSI NRO 001";"785800";"770084";"15716";"0";"0";"0";"223000";"111500";"111500";"0";"658584";"562800";"95784"
"3422";"1661104";"2018-04-09";"88915";"2018-04-09";"H-852-17   OTROSI NRO 001";"46000";"45080";"920";"0";"0";"0";"0";"0";"0";"0";"45080";"46000";"-920"
"3423";"1661601";"2018-04-09";"88915";"2018-04-09";"H-852-17   OTROSI NRO 001";"46000";"45080";"920";"0";"0";"0";"0";"0";"0";"0";"45080";"46000";"-920"
"3424";"1661612";"2018-04-09";"88915";"2018-04-09";"H-852-17   OTROSI NRO 001";"46000";"45080";"920";"0";"0";"0";"0";"0";"0";"0";"45080";"46000";"-920"
"3425";"1662093";"2018-04-09";"88915";"2018-04-09";"H-852-17   OTROSI NRO 001";"35900";"35182";"718";"0";"0";"0";"0";"0";"0";"0";"35182";"35900";"-718"
"3426";"1634859";"2018-04-09";"89333";"2018-04-09";"H-852-17   OTROSI NRO 001";"164640";"161347";"3293";"0";"0";"0";"0";"0";"0";"0";"161347";"164640";"-3293"
"3427";"1646599";"2018-04-09";"89346";"2018-04-09";"H-852-17   OTROSI NRO 001";"12217980";"11973620";"244360";"0";"0";"0";"749285";"419727";"329558";"0";"11553893";"329558";"11224335"
"3428";"1667528";"2018-04-09";"89286";"2018-04-09";"H-852-17   OTROSI NRO 001";"730675";"716061";"14614";"0";"0";"0";"223000";"223000";"0";"0";"493061";"237614";"255447"
"3429";"1655865";"2018-04-09";"89386";"2018-04-09";"H-852-17   OTROSI NRO 001";"55178";"54074";"1104";"0";"0";"0";"10388";"10388";"0";"0";"43686";"44790";"-1104"
"3430";"1656951";"2018-04-09";"89386";"2018-04-09";"H-852-17   OTROSI NRO 001";"824512";"808022";"16490";"0";"0";"0";"48800";"48800";"0";"0";"759222";"775712";"-16490"
"3431";"1660373";"2018-04-09";"89386";"2018-04-09";"H-852-17   OTROSI NRO 001";"29000";"28420";"580";"0";"0";"0";"0";"0";"0";"0";"28420";"29000";"-580"
"3432";"1660862";"2018-04-09";"89386";"2018-04-09";"H-852-17   OTROSI NRO 001";"66200";"64876";"1324";"0";"0";"0";"0";"0";"0";"0";"64876";"66200";"-1324"
"3433";"1661756";"2018-04-09";"89386";"2018-04-09";"H-852-17   OTROSI NRO 001";"439788";"430992";"8796";"0";"0";"0";"0";"0";"0";"0";"430992";"439788";"-8796"
"3434";"1665644";"2018-04-09";"89386";"2018-04-09";"H-852-17   OTROSI NRO 001";"61640";"60407";"1233";"0";"0";"0";"0";"0";"0";"0";"60407";"61640";"-1233"
"3435";"1665732";"2018-04-09";"89386";"2018-04-09";"H-852-17   OTROSI NRO 001";"44615";"43723";"892";"0";"0";"0";"0";"0";"0";"0";"43723";"44615";"-892"
"3436";"1666952";"2018-04-09";"89386";"2018-04-09";"H-852-17   OTROSI NRO 001";"111600";"109368";"2232";"0";"0";"0";"0";"0";"0";"0";"109368";"111600";"-2232"
"3437";"1667263";"2018-04-09";"89386";"2018-04-09";"H-852-17   OTROSI NRO 001";"135950";"133231";"2719";"0";"0";"0";"0";"0";"0";"0";"133231";"135950";"-2719"
"3438";"1668037";"2018-04-09";"89386";"2018-04-09";"H-852-17   OTROSI NRO 001";"1578048";"1546487";"31561";"0";"0";"0";"0";"0";"0";"0";"1546487";"1578048";"-31561"
"3439";"1668192";"2018-04-09";"89386";"2018-04-09";"H-852-17   OTROSI NRO 001";"202965";"198906";"4059";"0";"0";"0";"0";"0";"0";"0";"198906";"202965";"-4059"
"3440";"1668196";"2018-04-09";"89386";"2018-04-09";"H-852-17   OTROSI NRO 001";"697840";"683883";"13957";"0";"0";"0";"0";"0";"0";"0";"683883";"697840";"-13957"
"3441";"1668271";"2018-04-09";"89386";"2018-04-09";"H-852-17   OTROSI NRO 001";"1030847";"1010230";"20617";"0";"0";"0";"0";"0";"0";"0";"1010230";"1030847";"-20617"
"3442";"1624557";"2018-04-09";"89332";"2018-04-09";"H-852-17   OTROSI NRO 001";"1558593";"1527421";"31172";"0";"0";"0";"0";"0";"0";"0";"1527421";"1558593";"-31172"
"3443";"1645955";"2018-04-09";"89332";"2018-04-09";"H-852-17   OTROSI NRO 001";"1039062";"1018281";"20781";"0";"0";"0";"0";"0";"0";"0";"1018281";"1039062";"-20781"
"3444";"1629229";"2018-04-09";"89336";"2018-04-09";"H-852-17   OTROSI NRO 001";"5091263";"4989438";"101825";"0";"0";"0";"422200";"422200";"0";"0";"4567238";"4669063";"-101825"
"3445";"1632599";"2018-04-09";"89336";"2018-04-09";"H-852-17   OTROSI NRO 001";"1588498";"1556728";"31770";"0";"0";"0";"0";"0";"0";"0";"1556728";"1588498";"-31770"
"3446";"1652345";"2018-04-09";"88910";"2018-04-09";"H-852-17   OTROSI NRO 001";"46000";"45080";"920";"0";"0";"0";"0";"0";"0";"0";"45080";"46000";"-920"
"3447";"1652549";"2018-04-09";"88910";"2018-04-09";"H-852-17   OTROSI NRO 001";"56000";"54880";"1120";"0";"0";"0";"0";"0";"0";"0";"54880";"56000";"-1120"
"3448";"1652560";"2018-04-09";"88910";"2018-04-09";"H-852-17   OTROSI NRO 001";"56000";"54880";"1120";"0";"0";"0";"0";"0";"0";"0";"54880";"56000";"-1120"
"3449";"1652562";"2018-04-09";"88910";"2018-04-09";"H-852-17   OTROSI NRO 001";"70000";"68600";"1400";"0";"0";"0";"0";"0";"0";"0";"68600";"70000";"-1400"
"3450";"1652571";"2018-04-09";"88910";"2018-04-09";"H-852-17   OTROSI NRO 001";"46000";"45080";"920";"0";"0";"0";"0";"0";"0";"0";"45080";"46000";"-920"
"3451";"1652606";"2018-04-09";"88910";"2018-04-09";"H-852-17   OTROSI NRO 001";"56000";"54880";"1120";"0";"0";"0";"0";"0";"0";"0";"54880";"56000";"-1120"
"3452";"1652646";"2018-04-09";"88910";"2018-04-09";"H-852-17   OTROSI NRO 001";"46000";"45080";"920";"0";"0";"0";"0";"0";"0";"0";"45080";"46000";"-920"
"3453";"1652725";"2018-04-09";"88910";"2018-04-09";"H-852-17   OTROSI NRO 001";"46000";"45080";"920";"0";"0";"0";"0";"0";"0";"0";"45080";"46000";"-920"
"3454";"1653083";"2018-04-09";"88910";"2018-04-09";"H-852-17   OTROSI NRO 001";"35000";"34300";"700";"0";"0";"0";"0";"0";"0";"0";"34300";"35000";"-700"
"3455";"1653206";"2018-04-09";"88910";"2018-04-09";"H-852-17   OTROSI NRO 001";"112201";"109957";"2244";"0";"0";"0";"0";"0";"0";"0";"109957";"112201";"-2244"
"3456";"1653221";"2018-04-09";"88910";"2018-04-09";"H-852-17   OTROSI NRO 001";"138964";"136185";"2779";"0";"0";"0";"0";"0";"0";"0";"136185";"138964";"-2779"
"3457";"1653372";"2018-04-09";"88910";"2018-04-09";"H-852-17   OTROSI NRO 001";"46000";"45080";"920";"0";"0";"0";"0";"0";"0";"0";"45080";"46000";"-920"
"3458";"1653395";"2018-04-09";"88910";"2018-04-09";"H-852-17   OTROSI NRO 001";"56000";"54880";"1120";"0";"0";"0";"0";"0";"0";"0";"54880";"56000";"-1120"
"3459";"1653507";"2018-04-09";"88910";"2018-04-09";"H-852-17   OTROSI NRO 001";"46000";"45080";"920";"0";"0";"0";"0";"0";"0";"0";"45080";"46000";"-920"
"3460";"1653533";"2018-04-09";"88910";"2018-04-09";"H-852-17   OTROSI NRO 001";"46000";"45080";"920";"0";"0";"0";"0";"0";"0";"0";"45080";"46000";"-920"
"3461";"1653546";"2018-04-09";"88910";"2018-04-09";"H-852-17   OTROSI NRO 001";"41601";"40769";"832";"0";"0";"0";"0";"0";"0";"0";"40769";"41601";"-832"
"3462";"1653831";"2018-04-09";"88910";"2018-04-09";"H-852-17   OTROSI NRO 001";"56000";"54880";"1120";"0";"0";"0";"0";"0";"0";"0";"54880";"56000";"-1120"
"3463";"1653840";"2018-04-09";"88910";"2018-04-09";"H-852-17   OTROSI NRO 001";"46000";"45080";"920";"0";"0";"0";"0";"0";"0";"0";"45080";"46000";"-920"
"3464";"1653842";"2018-04-09";"88910";"2018-04-09";"H-852-17   OTROSI NRO 001";"35000";"34300";"700";"0";"0";"0";"0";"0";"0";"0";"34300";"35000";"-700"
"3465";"1654114";"2018-04-09";"88910";"2018-04-09";"H-852-17   OTROSI NRO 001";"470000";"460600";"9400";"0";"0";"0";"223000";"111500";"111500";"0";"349100";"247000";"102100"
"3466";"1654135";"2018-04-09";"88910";"2018-04-09";"H-852-17   OTROSI NRO 001";"470000";"460600";"9400";"0";"0";"0";"223000";"111500";"111500";"0";"349100";"247000";"102100"
"3467";"1654170";"2018-04-09";"88910";"2018-04-09";"H-852-17   OTROSI NRO 001";"730675";"716061";"14614";"0";"0";"0";"223000";"111500";"111500";"0";"604561";"507675";"96886"
"3468";"1658518";"2018-04-09";"88910";"2018-04-09";"H-852-17   OTROSI NRO 001";"56000";"54880";"1120";"0";"0";"0";"0";"0";"0";"0";"54880";"56000";"-1120"
"3469";"1658802";"2018-04-09";"88910";"2018-04-09";"H-852-17   OTROSI NRO 001";"14594";"14302";"292";"0";"0";"0";"0";"0";"0";"0";"14302";"14594";"-292"
"3470";"1658809";"2018-04-09";"88910";"2018-04-09";"H-852-17   OTROSI NRO 001";"14594";"14302";"292";"0";"0";"0";"0";"0";"0";"0";"14302";"14594";"-292"
"3471";"1659395";"2018-04-09";"88910";"2018-04-09";"H-852-17   OTROSI NRO 001";"70000";"68600";"1400";"0";"0";"0";"0";"0";"0";"0";"68600";"70000";"-1400"
"3472";"1659396";"2018-04-09";"88910";"2018-04-09";"H-852-17   OTROSI NRO 001";"70000";"68600";"1400";"0";"0";"0";"0";"0";"0";"0";"68600";"70000";"-1400"
"3473";"1659421";"2018-04-09";"88910";"2018-04-09";"H-852-17   OTROSI NRO 001";"46000";"45080";"920";"0";"0";"0";"0";"0";"0";"0";"45080";"46000";"-920"
"3474";"1659422";"2018-04-09";"88910";"2018-04-09";"H-852-17   OTROSI NRO 001";"46000";"45080";"920";"0";"0";"0";"0";"0";"0";"0";"45080";"46000";"-920"
"3475";"1659423";"2018-04-09";"88910";"2018-04-09";"H-852-17   OTROSI NRO 001";"46000";"45080";"920";"0";"0";"0";"0";"0";"0";"0";"45080";"46000";"-920"
"3476";"1660358";"2018-04-09";"88910";"2018-04-09";"H-852-17   OTROSI NRO 001";"46000";"45080";"920";"0";"0";"0";"0";"0";"0";"0";"45080";"46000";"-920"
"3477";"1660391";"2018-04-09";"88910";"2018-04-09";"H-852-17   OTROSI NRO 001";"56000";"54880";"1120";"0";"0";"0";"0";"0";"0";"0";"54880";"56000";"-1120"
"3478";"1665122";"2018-04-10";"89735";"2018-04-10";"H-852-17   OTROSI NRO 001";"15031873";"14731236";"300637";"0";"0";"0";"804000";"0";"804000";"0";"14731236";"804000";"13927236"
"3479";"1669386";"2018-04-10";"89699";"2018-04-10";"H-852-17   OTROSI NRO 001";"47910026";"46951825";"958201";"0";"0";"0";"2872422";"1927422";"945000";"0";"45024403";"473951";"44550452"
"3480";"1652206";"2018-04-10";"88917";"2018-04-10";"H-853-17   OTROSI NRO 001";"46000";"45080";"920";"0";"0";"0";"0";"0";"0";"0";"45080";"46000";"-920"
"3481";"1652568";"2018-04-10";"88917";"2018-04-10";"H-853-17   OTROSI NRO 001";"46000";"45080";"920";"0";"0";"0";"0";"0";"0";"0";"45080";"46000";"-920"
"3482";"1653166";"2018-04-10";"88917";"2018-04-10";"H-853-17   OTROSI NRO 001";"46000";"45080";"920";"0";"0";"0";"0";"0";"0";"0";"45080";"46000";"-920"
"3483";"1653479";"2018-04-10";"88917";"2018-04-10";"H-853-17   OTROSI NRO 001";"43000";"42140";"860";"0";"0";"0";"0";"0";"0";"0";"42140";"43000";"-860"
"3484";"1653792";"2018-04-10";"88917";"2018-04-10";"H-853-17   OTROSI NRO 001";"30950";"30331";"619";"0";"0";"0";"0";"0";"0";"0";"30331";"30950";"-619"
"3485";"1654745";"2018-04-10";"88917";"2018-04-10";"H-853-17   OTROSI NRO 001";"46000";"45080";"920";"0";"0";"0";"0";"0";"0";"0";"45080";"46000";"-920"
"3486";"1656290";"2018-04-10";"88917";"2018-04-10";"H-853-17   OTROSI NRO 001";"46000";"45080";"920";"0";"0";"0";"0";"0";"0";"0";"45080";"46000";"-920"
"3487";"1656582";"2018-04-10";"88917";"2018-04-10";"H-853-17   OTROSI NRO 001";"258256";"256031";"2225";"0";"0";"0";"10388";"10388";"0";"0";"245643";"247868";"-2225"
"3488";"1657245";"2018-04-10";"88917";"2018-04-10";"H-853-17   OTROSI NRO 001";"67000";"65660";"1340";"0";"0";"0";"0";"0";"0";"0";"65660";"67000";"-1340"
"3489";"1657857";"2018-04-10";"88917";"2018-04-10";"H-853-17   OTROSI NRO 001";"46000";"45080";"920";"0";"0";"0";"0";"0";"0";"0";"45080";"46000";"-920"
"3490";"1658594";"2018-04-10";"88917";"2018-04-10";"H-853-17   OTROSI NRO 001";"42100";"41258";"842";"0";"0";"0";"0";"0";"0";"0";"41258";"42100";"-842"
"3491";"1658918";"2018-04-10";"88917";"2018-04-10";"H-853-17   OTROSI NRO 001";"56000";"54880";"1120";"0";"0";"0";"0";"0";"0";"0";"54880";"56000";"-1120"
"3492";"1659159";"2018-04-10";"88917";"2018-04-10";"H-853-17   OTROSI NRO 001";"46000";"45080";"920";"0";"0";"0";"0";"0";"0";"0";"45080";"46000";"-920"
"3493";"1659169";"2018-04-10";"88917";"2018-04-10";"H-853-17   OTROSI NRO 001";"56000";"54880";"1120";"0";"0";"0";"0";"0";"0";"0";"54880";"56000";"-1120"
"3494";"1660975";"2018-04-10";"88917";"2018-04-10";"H-853-17   OTROSI NRO 001";"32000";"31360";"640";"0";"0";"0";"0";"0";"0";"0";"31360";"32000";"-640"
"3495";"1663462";"2018-04-10";"88917";"2018-04-10";"H-853-17   OTROSI NRO 001";"53000";"51940";"1060";"0";"0";"0";"0";"0";"0";"0";"51940";"53000";"-1060"
"3496";"1665554";"2018-04-10";"88917";"2018-04-10";"H-853-17   OTROSI NRO 001";"24452";"23963";"489";"0";"0";"0";"0";"0";"0";"0";"23963";"24452";"-489"
"3497";"1667043";"2018-04-10";"88917";"2018-04-10";"H-853-17   OTROSI NRO 001";"369100";"361718";"7382";"0";"0";"0";"0";"0";"0";"0";"361718";"369100";"-7382"
"3498";"1667676";"2018-04-10";"88917";"2018-04-10";"H-853-17   OTROSI NRO 001";"70000";"68600";"1400";"0";"0";"0";"0";"0";"0";"0";"68600";"70000";"-1400"
"3499";"1654672";"2018-04-10";"89447";"2018-04-10";"H-853-17   OTROSI NRO 001";"1131050";"1108429";"22621";"0";"0";"0";"578000";"0";"578000";"0";"1108429";"553050";"555379"
"3500";"1660851";"2018-04-10";"89447";"2018-04-10";"H-853-17   OTROSI NRO 001";"677550";"663999";"13551";"0";"0";"0";"2950";"2950";"0";"0";"661049";"674600";"-13551"
"3501";"1649687";"2018-04-10";"89548";"2018-04-10";"H-852-17   OTROSI NRO 001";"1538700";"1507926";"30774";"0";"0";"0";"0";"0";"0";"0";"1507926";"1538700";"-30774"
"3502";"1650529";"2018-04-10";"89548";"2018-04-10";"H-852-17   OTROSI NRO 001";"29000";"28420";"580";"0";"0";"0";"0";"0";"0";"0";"28420";"29000";"-580"
"3503";"1659878";"2018-04-10";"89548";"2018-04-10";"H-852-17   OTROSI NRO 001";"784550";"768859";"15691";"0";"0";"0";"84250";"0";"84250";"0";"768859";"700300";"68559"
"3504";"1659883";"2018-04-10";"89548";"2018-04-10";"H-852-17   OTROSI NRO 001";"99390";"97402";"1988";"0";"0";"0";"0";"0";"0";"0";"97402";"99390";"-1988"
"3505";"1662710";"2018-04-10";"89548";"2018-04-10";"H-852-17   OTROSI NRO 001";"1385243";"1357538";"27705";"0";"0";"0";"0";"0";"0";"0";"1357538";"1385243";"-27705"
"3506";"1665409";"2018-04-10";"89548";"2018-04-10";"H-852-17   OTROSI NRO 001";"1183984";"1160304";"23680";"0";"0";"0";"20800";"0";"20800";"0";"1160304";"1163184";"-2880"
"3507";"1666117";"2018-04-10";"89548";"2018-04-10";"H-852-17   OTROSI NRO 001";"172725";"169270";"3455";"0";"0";"0";"2650";"0";"2650";"0";"169270";"166620";"2650"
"3508";"1667727";"2018-04-10";"89548";"2018-04-10";"H-852-17   OTROSI NRO 001";"61500";"60270";"1230";"0";"0";"0";"0";"0";"0";"0";"60270";"61500";"-1230"
"3509";"1669231";"2018-04-10";"89548";"2018-04-10";"H-852-17   OTROSI NRO 001";"54140";"53057";"1083";"0";"0";"0";"0";"0";"0";"0";"53057";"54140";"-1083"
"3510";"1672476";"2018-04-10";"89548";"2018-04-10";"H-852-17   OTROSI NRO 001";"9503735";"9313660";"190075";"0";"0";"0";"1337200";"65000";"1272200";"0";"9248660";"8166535";"1082125"
"3511";"1667115";"2018-04-10";"89734";"2018-04-10";"H-852-17   OTROSI NRO 001";"58308971";"57142792";"1166179";"0";"0";"0";"5254580";"0";"5254580";"0";"57142792";"5254580";"51888212"
"3512";"1665937";"2018-04-10";"89737";"2018-04-10";"H-852-17   OTROSI NRO 001";"58888437";"57710668";"1177769";"0";"0";"0";"4520516";"1477558";"3042958";"0";"56233110";"745885";"55487225"
"3513";"1669397";"2018-04-10";"89756";"2018-04-10";"H-852-17   OTROSI NRO 001";"39538001";"38747241";"790760";"0";"0";"0";"1473506";"731700";"741806";"0";"38015541";"243130";"37772411"
"3514";"1662082";"2018-04-12";"89943";"2018-04-12";"H-852-17   OTROSI NRO 001";"1145366";"1122459";"22907";"0";"0";"0";"0";"0";"0";"0";"1122459";"1145366";"-22907"
"3515";"1667713";"2018-04-12";"89844";"2018-04-12";"H-852-17   OTROSI NRO 001";"345207";"338303";"6904";"0";"0";"0";"0";"0";"0";"0";"338303";"345207";"-6904"
"3516";"1643455";"2018-04-12";"89287";"2018-04-12";"H-852-17   OTROSI NRO 001";"22000";"21560";"440";"0";"0";"0";"2000";"2000";"0";"0";"19560";"20000";"-440"
"3517";"1648631";"2018-04-12";"89287";"2018-04-12";"H-852-17   OTROSI NRO 001";"27500";"26950";"550";"0";"0";"0";"2500";"2500";"0";"0";"24450";"25000";"-550"
"3518";"1654472";"2018-04-12";"89287";"2018-04-12";"H-852-17   OTROSI NRO 001";"11660";"11427";"233";"0";"0";"0";"0";"0";"0";"0";"11427";"11660";"-233"
"3519";"1661258";"2018-04-12";"89287";"2018-04-12";"H-852-17   OTROSI NRO 001";"52600";"51548";"1052";"0";"0";"0";"16665";"16665";"0";"0";"34883";"35935";"-1052"
"3520";"1665342";"2018-04-12";"89287";"2018-04-12";"H-852-17   OTROSI NRO 001";"11724";"11490";"234";"0";"0";"0";"0";"0";"0";"0";"11490";"11724";"-234"
"3521";"1669335";"2018-04-12";"89287";"2018-04-12";"H-852-17   OTROSI NRO 001";"9400000";"9212000";"188000";"0";"0";"0";"3788000";"3788000";"0";"0";"5424000";"5612000";"-188000"
"3522";"1667369";"2018-04-12";"89801";"2018-04-12";"H-852-17   OTROSI NRO 001";"2250000";"2205000";"45000";"0";"0";"0";"116700";"116700";"0";"0";"2088300";"2133300";"-45000"
"3523";"1667373";"2018-04-12";"89801";"2018-04-12";"H-852-17   OTROSI NRO 001";"2250000";"2205000";"45000";"0";"0";"0";"116700";"116700";"0";"0";"2088300";"2133300";"-45000"
"3524";"1658745";"2018-04-12";"88980";"2018-04-12";"H-852-17   OTROSI NRO 001";"47500";"46550";"950";"0";"0";"0";"23660";"23660";"0";"0";"22890";"23840";"-950"
"3525";"1667384";"2018-04-12";"89845";"2018-04-12";"H-852-17   OTROSI NRO 001";"3286426";"3220697";"65729";"0";"0";"0";"2811037";"741037";"2070000";"0";"2479660";"475389";"2004271"
"3526";"1667802";"2018-04-12";"89845";"2018-04-12";"H-852-17   OTROSI NRO 001";"70000";"68600";"1400";"0";"0";"0";"0";"0";"0";"0";"68600";"70000";"-1400"
"3527";"1672134";"2018-04-12";"89845";"2018-04-12";"H-852-17   OTROSI NRO 001";"274200";"268716";"5484";"0";"0";"0";"0";"0";"0";"0";"268716";"274200";"-5484"
"3528";"1672703";"2018-04-12";"89845";"2018-04-12";"H-852-17   OTROSI NRO 001";"31489";"34289";"-2800";"0";"0";"0";"0";"0";"0";"0";"34289";"31489";"2800"
"3529";"1605409";"2018-04-12";"89820";"2018-04-12";"H-593-15 OTRO SI NRO 002";"2415907";"2367589";"48318";"0";"0";"0";"0";"0";"0";"0";"2367589";"2415907";"-48318"
"3530";"1668963";"2018-04-12";"89671";"2018-04-12";"H-852-17   OTROSI NRO 001";"230108";"225506";"4602";"0";"0";"0";"0";"0";"0";"0";"225506";"230108";"-4602"
"3531";"1669031";"2018-04-12";"89671";"2018-04-12";"H-852-17   OTROSI NRO 001";"772108";"756666";"15442";"0";"0";"0";"300149";"0";"300149";"0";"756666";"471959";"284707"
"3532";"1660194";"2018-04-12";"88921";"2018-04-12";"H-852-17   OTROSI NRO 001";"104720";"102626";"2094";"0";"0";"0";"0";"0";"0";"0";"102626";"104720";"-2094"
"3533";"1664287";"2018-04-12";"88921";"2018-04-12";"H-852-17   OTROSI NRO 001";"120290";"117884";"2406";"0";"0";"0";"0";"0";"0";"0";"117884";"120290";"-2406"
"3534";"1665696";"2018-04-12";"88921";"2018-04-12";"H-852-17   OTROSI NRO 001";"90990";"89170";"1820";"0";"0";"0";"0";"0";"0";"0";"89170";"90990";"-1820"
"3535";"1672473";"2018-04-12";"89522";"2018-04-12";"0";"5875";"5757";"118";"0";"0";"0";"0";"0";"0";"0";"5757";"5875";"-118"
"3536";"1673555";"2018-04-12";"89897";"2018-04-12";"H-852-17   OTROSI NRO 001";"6428569";"6299998";"128571";"0";"0";"0";"704924";"394627";"310297";"0";"5905371";"5723645";"181726"
"3537";"1653922";"2018-04-12";"88920";"2018-04-12";"H-852-17   OTROSI NRO 001";"32775";"32119";"656";"0";"0";"0";"0";"0";"0";"0";"32119";"32775";"-656"
"3538";"1654275";"2018-04-12";"88920";"2018-04-12";"H-852-17   OTROSI NRO 001";"105875";"103757";"2118";"0";"0";"0";"7275";"0";"7275";"0";"103757";"98600";"5157"
"3539";"1656061";"2018-04-12";"88920";"2018-04-12";"H-852-17   OTROSI NRO 001";"30800";"30184";"616";"0";"0";"0";"0";"0";"0";"0";"30184";"30800";"-616"
"3540";"1662775";"2018-04-12";"88920";"2018-04-12";"H-852-17   OTROSI NRO 001";"42300";"41454";"846";"0";"0";"0";"0";"0";"0";"0";"41454";"42300";"-846"
"3541";"1666678";"2018-04-12";"88920";"2018-04-12";"H-852-17   OTROSI NRO 001";"281195";"275571";"5624";"0";"0";"0";"0";"0";"0";"0";"275571";"281195";"-5624"
"3542";"1663264";"2018-04-12";"89524";"2018-04-12";"H-852-17   OTROSI NRO 001";"12545955";"12295036";"250919";"0";"0";"0";"1353500";"1353500";"0";"0";"10941536";"11192455";"-250919"
"3543";"1668711";"2018-04-12";"89524";"2018-04-12";"H-852-17   OTROSI NRO 001";"1366154";"1338831";"27323";"0";"0";"0";"0";"0";"0";"0";"1338831";"1366154";"-27323"
"3544";"1668635";"2018-04-12";"89220";"2018-04-12";"H-852-17   OTROSI NRO 001";"82320";"80674";"1646";"0";"0";"0";"0";"0";"0";"0";"80674";"82320";"-1646"
"3545";"1669348";"2018-04-12";"89743";"2018-04-12";"H-852-17   OTROSI NRO 001";"12024215";"11783731";"240484";"0";"0";"0";"1161023";"649439";"511584";"0";"11134292";"511584";"10622708"
"3546";"1623737";"2018-04-12";"89884";"2018-04-12";"H-852-17   OTROSI NRO 001";"1558593";"1527421";"31172";"0";"0";"0";"116700";"116700";"0";"0";"1410721";"1441893";"-31172"
"3547";"1623934";"2018-04-12";"89884";"2018-04-12";"H-852-17   OTROSI NRO 001";"2250000";"2205000";"45000";"0";"0";"0";"116700";"116700";"0";"0";"2088300";"2133300";"-45000"
"3548";"1668567";"2018-04-12";"89731";"2018-04-12";"H-852-17   OTROSI NRO 001";"738814";"724038";"14776";"0";"0";"0";"0";"0";"0";"0";"724038";"738814";"-14776"
"3549";"1633566";"2018-04-12";"89476";"2018-04-12";"H-852-17   OTROSI NRO 001";"4915";"4817";"98";"0";"0";"0";"0";"0";"0";"0";"4817";"4915";"-98"
"3550";"1648673";"2018-04-12";"89476";"2018-04-12";"H-852-17   OTROSI NRO 001";"27500";"26950";"550";"0";"0";"0";"2500";"2500";"0";"0";"24450";"25000";"-550"
"3551";"1661960";"2018-04-12";"89476";"2018-04-12";"H-852-17   OTROSI NRO 001";"7450";"7301";"149";"0";"0";"0";"1675";"1675";"0";"0";"5626";"5775";"-149"
"3552";"1672466";"2018-04-12";"89476";"2018-04-12";"0";"45000";"44100";"900";"0";"0";"0";"9825";"9825";"0";"0";"34275";"35175";"-900"
"3553";"1669445";"2018-04-19";"90164";"2018-04-19";"H-852-17   OTROSI NRO 001";"500000";"490000";"10000";"0";"0";"0";"0";"0";"0";"0";"490000";"500000";"-10000"
"3554";"1690006";"2018-05-18";"91108";"2018-05-18";"H-852-17   OTROSI NRO 001";"4293551";"4088218";"205333";"0";"0";"0";"134150";"79500";"54650";"0";"4008718";"4037501";"-28783"
"3555";"1624187";"2018-05-21";"91207";"2018-05-21";"H-852-17   OTROSI NRO 001";"2250000";"2205000";"45000";"0";"0";"0";"0";"0";"0";"0";"2205000";"2250000";"-45000"
"3556";"1630827";"2018-05-21";"90919";"2018-05-21";"H-852-17   OTROSI NRO 001";"45190";"44286";"904";"0";"0";"0";"3990";"0";"3990";"0";"44286";"41200";"3086"
"3557";"1631823";"2018-05-21";"90919";"2018-05-21";"H-852-17   OTROSI NRO 001";"276100";"270578";"5522";"0";"0";"0";"0";"0";"0";"0";"270578";"276100";"-5522"
"3558";"1632429";"2018-05-21";"90919";"2018-05-21";"H-852-17   OTROSI NRO 001";"67135";"65792";"1343";"0";"0";"0";"0";"0";"0";"0";"65792";"67135";"-1343"
"3559";"1634760";"2018-05-21";"90919";"2018-05-21";"H-852-17   OTROSI NRO 001";"82290";"80644";"1646";"0";"0";"0";"31200";"31200";"0";"0";"49444";"51090";"-1646"
"3560";"1635977";"2018-05-21";"90919";"2018-05-21";"H-852-17   OTROSI NRO 001";"71690";"70256";"1434";"0";"0";"0";"0";"0";"0";"0";"70256";"71690";"-1434"
"3561";"1637465";"2018-05-21";"90919";"2018-05-21";"H-852-17   OTROSI NRO 001";"29000";"28420";"580";"0";"0";"0";"0";"0";"0";"0";"28420";"29000";"-580"
"3562";"1686853";"2018-05-22";"91117";"2018-05-22";"0";"7274";"7129";"145";"0";"0";"0";"0";"0";"0";"0";"7129";"7274";"-145"
"3563";"1644321";"2018-06-12";"92592";"2018-06-12";"H-852-17   OTROSI NRO 001";"15083054";"14781393";"301661";"0";"0";"0";"3546233";"3507233";"39000";"0";"11274160";"39000";"11235160"
"3564";"1678569";"2018-07-10";"95119";"2018-07-10";"H-852-17   OTROSI NRO 001";"428992";"420412";"8580";"0";"0";"0";"0";"0";"0";"0";"420412";"428992";"-8580"
"3565";"1808074";"2018-09-20";"98251";"2018-09-20";"H-852-17   OTROSI NRO 001";"3062900";"3001642";"61258";"0";"0";"0";"420893";"408893";"12000";"0";"2592749";"12000";"2580749"
"3566";"1808076";"2018-09-20";"98251";"2018-09-20";"H-852-17   OTROSI NRO 001";"2055139";"2014036";"41103";"0";"0";"0";"419654";"407654";"12000";"0";"1606382";"1200";"1605182"
"3567";"1808079";"2018-09-20";"98253";"2018-09-20";"H-852-17   OTROSI NRO 001";"2492506";"2442656";"49850";"0";"0";"0";"1001204";"163029";"838174";"1";"2279627";"2329477";"-49850"
